 
Gades | Gades, ium f
Gadexylum | Gadexyl(um, i n
gaesum | gaesum, i n
Gaetuli | Gaetuli, orum m
galactocele | galactocele, es f
galactorrhoea | galactorrhoea, ae f
galactostasis | galactostasis, is f
Galba | Galba, ae m
galbanum | galbanum, i n
galea | galea, ae f
galeo | galeo, avi, atum, are pass.
galerum | galerum, i n
galerus | galerus, i m
galla | galla, ae f
Galli | Galli, orum m
Gallia | Gallia, ae f
gallina | gallina, ae f
gallus | I gallus, i m
Galmaninum | Galmanin(um, i n
gamogenesis | gamogenesis, is f
ganea | ganea, ae f
ganeo | ganeo, onis m
ganeum | ganeum, i n
Ganges | Ganges, is ( acc.
ganglion | ganglion, i n
Gangliostatum | Gangliostat(um, i n
Ganymedes | Ganymedes, is m
Gardenalum | Gardenal(um, i n
Garimicinum | Garimicin(um, i n
garon | garon (garum), i n
garrulitas | garrulitas, atis f
garrulus | garrulus, a, um поэт.
garum | garum, i n
Garumna | Garumna, ae m
gas | I gas n
gaster | gaster, tris f
gastralgia | gastralgia, ae f
gastrectasia | gastrectasia, ae f
gastrectomia | gastrectomia, ae f
gastricus | gastricus, a, um анат.
Gastriponum | Gastripon(um, i n
gastritis | gastritis, idis f
Gastrobamatum | Gastrobamat(um, i n
gastrocele | gastrocele, es f
gastrocnemius | gastrocnemius, a, um анат.
gastrocolicus | gastrocolicus, a, um анат.
gastroduodenalis | gastroduodenalis, e анат.
gastroduodenoscopia | gastroduodenoscopia, ae f
gastroduodenostomia | gastroduodenostomia, ae f
gastroenteritis | gastroenteritis, idis f
gastroenterocolitis | gastroenterocolitis, idis f
gastroenterologia | gastroenterologia, ae f
gastroenterostomia | gastroenterostomia, ae f
gastroepiploicus | gastroepiploicus, a, um анат.
gastroesophagostomia | gastroesophagostomia, ae f
gastrogenus | gastrogenus, a, um мед.
gastrointestinalis | gastrointestinalis, e мед.
gastrolienalis | gastrolienalis, e анат.
gastropancreaticus | gastropancreaticus, a, um анат.
gastrophrenicus | gastrophrenicus, a, um анат.
Gastropoda | Gastropoda, orum n
gastroptosis | gastroptosis, is f
gastrorrhagia | gastrorrhagia, ae f
gastroscopia | gastroscopia, ae f
gastrospasmus | gastrospasmus, i m
gastrostoma | gastrostoma, atis n
gastrostomia | gastrostomia, ae f
gastrula | gastrula, ае f
gastrulatio | gastrulatio, onis f
gaudium | gaudium, i n
gausape | gausape, is n
gausapum | gausapum, i n
gaza | gaza, ae f
gelatina | gelatina, ae f
gelatinosus | gelatinosus, a, um фармац.
gelicidium | gelicidium, i n
gelida | gelida, ae f
gelide | gelide adv.
gelidus | gelidus, a, um поэт.
gelu | gelu, us n
gemellus | gemellus, a, um анат.
gemino | gemino, avi, atum, are pass.
gemitus | gemitus, us m
gemma | gemma, ae f
gemmatio | gemmatio, onis f
gena | gena, ae f
Genacortum | Genacort(um, i n
Genasprinum | Genasprin(um, i n
Genava | Genava, ae f
gener | gener, eri m
generatim | generatim adv.
generatio | generatio, onis f
generator | generator, oris m
genero | genero, avi, atum, are pass.
generose | generose adv.
genesis | genesis, is f
genetrix | genetrix, icis f
genialis | I genialis, e m
genialiter | genialiter adv.
geniculum | geniculum, i n
genioglossus | genioglossus, a, um анат.
genion | genion, i n
genista | genista, ae f
genitalis | genitalis, e анат.
genitofemoralis | genitofemoralis, e анат.
genitoinguinalis | genitoinguinalis, e анат.
genitor | genitor, oris m
genius | genius, i m
geno | geno, nui, nitum, ere арх.
Genocainum | Genocain(um, i n
Genophyllinum | Genophyllin(um, i n
genotypus | genotypus, i m
Genoxalum | Genoxal(um, i n
gens | gens, gentis f
Gentiana | Gentiana, ae f
genu | genu, us n
Genua | Genua, ae f
genuale | genuale, is n
genus | genus, eris n
Geocortonum | Geocorton(um, i n
Geomycinum | Geomycin(um, i n
Gergovia | Gergovia, ae f
Geriocainum | Geriocain(um, i n
germana | germana, ae f
Germani | Germani, orum m
Germania | Germania, ae f
germanicus | I germanicus, a, um m
germanitas | germanitas, atis f
germanus | I germanus, a, um m
germen | germen, inis n
germinativus | germinativus, a, um ����.
gero | gero, gessi, gestum, ere pass.
Gerodylum | Gerodyl(um, i n
Gerovitum | Gerovit(um, i n
Gerulcinum | Gerulcin(um, i n
gerulus | gerulus, i m
gestamen | gestamen, inis n
Gestonum | Geston(um, i n
gestus | gestus, us m
Getae | Getae, arum m
Gidomycinum | Gidomycin(um, i n
gignentia | gignentia, ium n
Gilurytmalum | Gilurytmal(um, i n
Ginandrinum | Ginandrin(um, i n
Gineflavirum | Gineflavir(um, i n
gingiva | gingiva, ае f
ginglymus | ginglymus, i m
Girepinum | Girepin(um, i n
Gitalenum | Gitalen(um, i n
Gitoxinum | Gitoxin(um, i n
glabella | glabella, ае f
glacies | glacies, ei f
gladiator | gladiator, oris m
gladiatorium | gladiatorium, i n
gladius | gladius, i m
glaeba | glaeba, ae f
Glandubolinum | Glandubolin(um, i n
Glanduitrinum | Glanduitrin(um, i n
glandula | glandula, ae f
glandularis | glandularis, e анат.
glans | glans, glandis f
glarea | glarea, ae f
Glaucidium | Glaucidium, i n
glaucoma | glaucoma, atis n
Glaucomilum | Glaucomil(um, i n
Glaxoridinum | Glaxoridin(um, i n
gleba | gleba, ae f
glenohumeralis | glenohumeralis, e анат.
glenoidalis | glenoidalis, e анат.
glia | glia, ae f
Glimidum | Glimid(um, i n
Globinecolum | Globinecol(um, i n
Globucidum | Globucid(um, i n
globulus | globulus, i m
globus | globus, i m
glomero | glomero, avi, atum, are pass.
glomerulus | glomerulus, i m
glomiformis | glomiformis, e анат.
glomus | glomus, eris n
gloria | gloria, ae f
gloriose | gloriose adv.
glossa | glossa, ае f
glossalgia | glossalgia, ae f
glossitis | glossitis, idis f
glossoepiglotticus | glossoepiglotticus, a, um анат.
glossopharyngeus | glossopharyngeus, a, um анат.
glossoplastica | glossoplastica, ae f
glossoplegia | glossoplegia, ae f
glossoptosis | glossoptosis, is f
glossorrhagia | glossorrhagia, ae f
glottis | glottis, idis f
gluconas | gluconas, atis m
Glucosum | Glucosum, i n
glucosuria | glucosuria, ae f
Glutansinum | Glutansin(um, i n
Glutanum | Glutan(um, i n
Glutathimidum | Glutathimid(um, i n
Glutavitum | Glutavit(um, i n
gluten | gluten, inis n
gluteus | gluteus, a, um анат.
glutinum | glutinum, i n
Glutosalylum | Glutosalyl(um, i n
Glycerinum | Glycerin(um, i n
glycerophosphas | glycerophosphas, atis m
Glycerophosphatum | Glycerophosphat(um, i n
Glycerophosphenum | Glycerophosphen(um, i n
Glycocyclinum | Glycocyclin(um, i n
glycogenum | glycogenum, i n
glycophyta | glycophyta, orum n
Glycyrrhiza | Glycyrrhiza, ae f
glykaemia | glykaemia, ae f
Glyphyllinum | Glyphyllin(um, i n
Glyvenolum | Glyvenol(um, i n
gnaritas | gnaritas, atis f
gnathalgia | gnathalgia, ae f
gnathoplastica | gnathoplastica, ae f
Gnathostomata | Gnathostomata, um n
gnatus | gnatus, a, um арх.
gnav | gnav арх.
gobius | gobius (cobius), i m
Golgotha | Golgotha m
gomphosis | gomphosis, is f
Gomphotinum | Gomphotin(um, i n
Gonabionum | Gonabion(um, i n
Gonavitum | Gonavit(um, i n
Gonocrinum | Gonocrin(um, i n
gonocytus | gonocytus, i m
Gontochinum | Gontochin(um, i n
Gordium | Gordium, i n
Gorgias | Gorgias, ае m
Gorgones | Gorgones, um f
gossypium | gossypium, i n
Gothi | Gothi, orum m
grabatus | grabatus, i m
Gracchus | Gracchus, i m
Gracidinum | Gracidin(um, i n
gradatim | gradatim adv.
gradus | gradus, us m
Graecia | Graecia, ae f
Graecus | I Graecus, a, um m
Grajus | Grajus, i m
gramen | gramen, inis n
Gramicidinum | Gramicidin(um, i n
gramma | gramma, atis n
grammatica | I grammatica, ae f
grammaticus | I grammaticus, a, um m
granarium | granarium, i n
Granatus | Granatus, i f
grandiflorus | grandiflorus, a, um бот.
grandino | grandino, --, --, are impers.
granditer | granditer adv.
grando | grando, inis f
Granicus | Granicus, i m
granulans | granulans, antis мед.
granulatio | granulatio, onis f
granulosus | granulosus, a, um анат.
granum | granum, i n
graphium | graphium, i n
graphomachina | graphomachina, ae f
grassator | grassator, oris m
grate | grate adv.
grates | grates ( acc.
gratia | I gratia, ae f
Gratiae | Gratiae, arum f
gratificatio | gratificatio, onis f
gratiis | gratiis арх.
gratis | gratis adv.
gratuito | gratuito adv.
gratulatio | gratulatio, onis f
gravanter | gravanter adv.
gravatim | gravatim adv.
gravesco | gravesco, --, --, ere поэт.
gravitas | gravitas, atis f
graviter | graviter adv.
Gravitolum | Gravitol(um, i n
gravo | gravo, avi, atum, are pass.
gregales | gregales, ium m
gregatim | gregatim adv.
gremium | gremium, i n
Greosinum | Greosin(um, i n
gressus | gressus, us m
grex | grex, gregis m
Gricinum | Gricin(um, i n
Grifulinum | Grifulin(um, i n
Grifulvinum | Grifulvin(um, i n
grippa | grippa, ae f
Griroxilum | Griroxil(um, i n
Grisactinum | Grisactin(um, i n
Grisefulinum | Grisefulin(um, i n
Griseofulvinum | Griseofulvin(um, i n
griseus | griseus, a, um анат.
Grisovinum | Grisovin(um, i n
grus | grus (поэт. gruis), gruis m
gryps | gryps, grypis m
Guamidum | Guamid(um, i n
Guanatolum | Guanatol(um, i n
Guanethidinum | Guanethidin(um, i n
Guanisolum | Guanisol(um, i n
Guaseptum | Guasept(um, i n
gubernaculum | I gubernaculum, i n
gubernatio | gubernatio, onis f
gubernator | gubernator, oris m
gubernatrix | gubernatrix, icis f
Guimrinum | Guimrin(um, i n
gula | gula, ae f
Gumisolum | Gumisol(um, i n
gumnasium | gumnasium, i n
gurges | gurges, itis m
gurgulio | I gurgulio, onis m
gurgustium | gurgustium, i n
gustatorius | gustatorius, a, um анат.
gustatus | gustatus, us m
gustus | gustus, us m
gutta | gutta, ae f
guttur | guttur, uris n
guttus | guttus, i m
gymnandrus | gymnandrus, a, um бот.
gymnasiarchus | gymnasiarchus, i m
gymnasium | gymnasium (gumnasium), i n
Gymnospermae | Gymnospermae, arum f
gymnospermus | gymnospermus, a, um бот.
gynaeceum | gynaeceum (gynaecium), i n
gynaecium | gynaecium, i n
gynaecologia | gynaecologia, ae f
gynaecologus | gynaecologus, i m
gynaeconitis | gynaeconitis, idis f
gynaecophobia | gynaecophobia, ae f
gynecologicus | gynecologicus, a, um мед.
Gynformonum | Gynformon(um, i n
Gynlutinum | Gynlutin(um, i n
Gynoestrylum | Gynoestryl(um, i n
Gynofortum | Gynofort(um, i n
gynophorum | gynophorum, i n
Gynoralum | Gynoral(um, i n
gypsum | gypsum, i n
Gyromytra | Gyromytra, ae f
gyrus | gyrus, i m
