 
jaceo | jaceo, cui, (citum), ere поэт.
jactatio | jactatio, onis f
jactatus | jactatus, us m
jacto | jacto, avi, atum, are pass.
jactura | jactura, ae f
jactus | jactus, us m
jaculator | jaculator, oris m
jaculatrix | jaculatrix, icis f
jaculum | jaculum, i n
jam | jam adv.
jangala | jangala, orum n
Janiculum | Janiculum, i n
janitor | janitor, oris m
janua | janua, ae f
Januarius | Januarius, i m
Janus | Janus, i m
Jasminum | Jasminum, i n
jecur | jecur, jecoris (jecinoris) n
jecusculum | jecusculum, i n
jejunium | I jejunium, i n
jejunus | jejunus, a, um поэт.
Jenacainum | Jenacain(um, i n
jentaculum | jentaculum, i n
Jestrylum | Jestryl(um, i n
jocose | jocose adv.
jocularia | jocularia, ium n
joculator | joculator, oris m
jocus | jocus, i m
Jodglobinum | Jodglobin(um, i n
Jodgorgonum | Jodgorgon(um, i n
Jodipamidum | Jodipamid(um, i n
Jodoalphionicum | Jodoalphionic(um, i n
Jodobilanum | Jodobilan(um, i n
Jodobilum | Jodobil(um, i n
Jodopyracetum | Jodopyracet(um, i n
juba | juba, ae f
jubar | jubar, aris n
jubeo | jubeo, jussi, jussum, ere pass.
jucunde | jucunde adv.
jucunditas | jucunditas, atis f
judex | judex, icis m
judicatio | judicatio, onis f
judicatum | judicatum, i n
judicatus | I judicatus, a, um m
judicium | judicium, i n
jugatio | jugatio, onis f
jugerum | jugerum, i n
jugo | jugo, avi, atum, are поэт.
jugularis | jugularis, e анат.
jugulodigastricus | jugulodigastricus, a, um анат.
juguloomohyoideus | juguloomohyoideus, a, um анат.
jugulum | jugulum, i n
jugum | jugum, i n
Jugurtha | Jugurtha, ae m
Julia | Julia, ae f
Julianus | Julianus, i m
Julius | I Julius, a, um m
Julus | Julus, i m
jumentum | jumentum, i n
junctura | junctura, ae f
juncus | juncus, i m
jungo | jungo, junxi, junctum, ere pass.
Juniperus | Juniperus, i f
Junius | I Junius, a, um m
Juno | Juno, onis f
Juppiter | Juppiter, Jovis m
Jura | Jura, ae m
jurator | jurator, oris m
juratus | I juratus, a, um part.
jurgium | jurgium, i n
jurisdictio | jurisdictio, onis f
jus | I jus, juris n
jus-jurandum | jus-jurandum, juris-jurandi n
jussum | jussum, i n
jussus | jussus, us m
justa | justa, orum n
juste | juste adv.
justitia | justitia, ae f
justitium | justitium, i n
juvenalis | I juvenalis, e m
juvenaliter | juvenaliter adv.
juvenca | juvenca, ae f
juvencus | I juvencus, a, um m
juveniliter | juveniliter adv.
juvenis | I juvenis, is compar.
juventa | juventa, ae f
juventas | juventas, atis f
juventus | juventus, utis f
juvo | juvo, juvi, jutum, are part.
juxta | I juxta praep.
