 
Pabestrolum | Pabestrolum, i n
pabulatio | pabulatio, onis f
pabulator | pabulator, oris m
pabulum | pabulum, i n
pacata | pacata, orum n
Pacatalum | Pacatalum, i n
Pachycarpinum | Pachycarpinum, i n
pachycarpus | pachycarpus, a, um биолог.
pachymeninx | pachymeninx, ingis f
pacificatio | pacificatio, onis f
pacificator | pacificator, oris m
Pacinolum | Pacinolum, i n
Pacinonum | Pacinonum, i n
Pacitrinum | Pacitrinum, i n
pacta | pacta, ae f
pactio | pactio, onis f
pactor | pactor, oris m
pactum | pactum, i n
Pacuvius | Pacuvius, i m
Padicorum | Padicorum, i n
Padus | I Padus, i f
Padutinum | Padutinum, i n
paean | I paean, anis m
paedagogus | paedagogus, i m
paediater | paediater, tri m
paediatria | paediatria, ae f
paedor | paedor, oris m
paelex | paelex, icis f
paelicatus | paelicatus, us m
paene | paene adv.
paeninsula | paeninsula, ae f
paenula | paenula, ae f
paenuria | paenuria, ae f
paeon | paeon, onis m
paganus | I paganus, a, um m
pagella | pagella, ae f
pagina | pagina, ae f
paginula | paginula, ae f
pagus | pagus, i m
pala | pala, ae f
Palacrinum | Palacrinum, i n
palaestra | palaestra, ae f
palaestrice | palaestrice adv.
palaestrita | palaestrita, ae m
palam | I palam adv.
Palatinus | I Palatinus, a, um анат.
Palatium | Palatium, i n
palatoethmoidalis | palatoethmoidalis, e анат.
palatoglossus | palatoglossus, a, um анат.
palatomaxillaris | palatomaxillaris, e анат.
palatopharyngeus | palatopharyngeus, a, um анат.
palatovaginalis | palatovaginalis, e анат.
palatum | palatum, i n
palatus | palatus, i m
palea | palea, ae f
palear | palear, aris n
paleencephalon | paleencephalon, i n
paleocerebellum | paleocerebellum, i n
paleocortex | paleocortex, icis f
Palerolum | Palerolum, i n
Pales | Pales, is f
Palfium | Palfium, i n
palimpsestus | palimpsestus, i m
Palinum | Palinum, i n
paliurus | paliurus, i m
palla | palla, ae f
Palladium | Palladium, i n
Pallas | I Pallas, adis (ados) f
palleo | palleo, pallui, --, ere поэт.
pallesco | pallesco, pallui, --, ere поэт.
Pallicidum | Pallicidum, i n
pallidothalamicus | pallidothalamicus, a, um анат.
palliolum | palliolum, i n
pallium | pallium, i n
pallor | pallor, oris m
palma | palma, ae f
palmaris | palmaris, e анат.
palmatus | palmatus, a, um анат.
palmes | palmes, itis m
palmetum | palmetum, i n
palmula | palmula, ae f
palpatio | palpatio, onis f
palpebra | palpebra, ae f
palpebralis | palpebralis, e анат.
Palphium | Palphium, i n
paludamentum | paludamentum, i n
Paludrinum | Paludrinum, i n
palumbes | palumbes, is m
palus | I palus, i m
Palusilum | Palusilum, i n
Pamisylum | Pamisylum, i n
Pamoxanum | Pamoxanum, i n
pampiniformis | pampiniformis, e анат.
pampinus | pampinus, i m
Pan | Pan, Panis (Panos) m
panacea | panacea, ae f
Panadolum | Panadolum, i n
panalgia | panalgia, ae f
Pananginum | Pananginum, i n
panaritium | panaritium, i n
panarthritis | panarthritis, idis f
Panax | Panax Ginseng (Shin-seng) фармац.
Pancainum | Pancainum, i n
Pancalum | Pancalum, i n
pancarditis | pancarditis, idis f
pancreas | pancreas, atis n
pancreaticoduodenalis | pancreaticoduodenalis, e анат.
pancreaticolienalis | pancreaticolienalis, e анат.
pancreaticus | pancreaticus, a, um анат.
Pancreatinum | Pancreatinum, i n
pancreatitis | pancreatitis, idis f
Pandigalum | Pandigalum, i n
pando | pando, pandi, pansum (passum), ere pass.
panegyricus | panegyricus, i m
Panergalum | Panergalum, i n
Panflavinum | Panflavinum, i n
pango | pango, pepigi поэт.
Panhexavitum | Panhexavitum, i n
panhysterectomia | panhysterectomia, ae f
panicum | panicum, i n
panis | panis, is m
Paniverinum | Paniverinum, i n
Pankalma | Pankalma, ае f
Panmycinum | Panmycinum, i n
panniculus | panniculus, i m
Pannonia | Pannonia, ae f
pannus | pannus, i m
Panodormum | Panodormum, i n
Pantalganum | Pantalganum, i n
pantex | pantex, icis m
panthera | panthera, ae f
Panthojectum | Panthojectum, i n
Pantholinum | Pantholinum, i n
Pantocainum | Pantocainum, i n
Pantocidum | Pantocidum, i n
Pantocrinum | Pantocrinum, i n
Pantolaxum | Pantolaxum, i n
Pantomycinum | Pantomycinum, i n
pantophagus | pantophagus, a, um биолог.
Pantopoda | Pantopoda, um n
Pantoponum | Pantoponum, i n
Pantoseptum | Pantoseptum, i n
Pantotenum | Pantotenum, i n
Pantothaxinum | Pantothaxinum, i n
Pantotonum | Pantotonum, i n
Pantrypinum | Pantrypinum, i n
Panurinum | Panurinum, i n
panvasculitis | panvasculitis, idis f
panzootia | panzootia, ae f
Papaver | Papaver, eris n
Papaveratum | Papaveratum, i n
Papaverinum | Papaverinum, i n
Papazolum | Papazolum, i n
Paphlagonia | Paphlagonia, ae f
Paphos | Paphos (-us), i m
Paphyllinum | Paphyllinum, i n
papilio | papilio, onis m
papilla | papilla, ae f
papillaris | papillaris, e анат.
papula | papula, ae f
papyraceus | papyraceus, a, um анат.
papyrus | papyrus, i m
par | par, paris subst.
paraaorticus | paraaorticus, a, um анат.
Paracainum | Paracainum, i n
paracentralis | paracentralis, e анат.
Paracetamolum | Paracetamolum, i n
paracolitis | paracolitis, idis f
Paracortolum | Paracortolum, i n
Paracortum | Paracortum, i n
paracystitis | paracystitis, idis f
paradidymis | paradidymis, idis f
Paradionum | Paradionum, i n
paradoxa | paradoxa, orum n
paraduodenalis | paraduodenalis, e анат.
paraffinatus | paraffinatus, a, um фармац.
Paraffinum | Paraffinum, i n
Paraflexum | Paraflexum, i n
paraflocculus | paraflocculus, i m
paraganglion | paraganglion, i n
parahippocampalis | parahippocampalis, e анат.
Paralestum | Paralestum, i n
paralysis | paralysis, is f
paramastoideus | paramastoideus, a, um анат.
paramesonephricus | paramesonephricus, a, um анат.
parametritis | parametritis, idis f
parametrium | parametrium, i n
Paramyonum | Paramyonum, i n
paranasalis | I paranasalis, e анат.
parancphritis | parancphritis, idis f
Paranephrinum | Paranephrinum, i n
paranephros | paranephros, i m
paraneuralis | paraneuralis, e анат.
paraolivarius | paraolivarius, a, um анат.
parapancreaticus | parapancreaticus, a, um анат.
parapharyngealis | parapharyngealis, e анат.
parapharyngeus | parapharyngeus, a, um мед.
paraphysis | paraphysis, is f
parapinealis | parapinealis, e анат.
paraproctitis | paraproctitis, idis f
paraproctus | paraproctus, i m
pararectalis | pararectalis, e анат.
parasacralis | parasacralis, e анат.
Parasalum | Parasalum, i n
Parasanum | Parasanum, i n
parasita | parasita, ae f
parasitus | parasitus, i m
parasternalis | parasternalis, e анат.
parasympathicus | parasympathicus, a, um анат.
parata | parata, orum n
parate | parate adv.
paraterminalis | paraterminalis, e анат.
Parathesinum | Parathesinum, i n
Parathormonum | Parathormonum, i n
Parathyreocrinum | Parathyreocrinum, i n
Parathyreoidinum | Parathyreoidinum, i n
paratio | paratio, onis f
paratus | I paratus, a, um m
paratyphus | paratyphus, i m
paraumbilicalis | paraumbilicalis, e анат.
paraurethralis | paraurethralis, e анат.
paravaginalis | paravaginalis, e анат.
paraventricularis | paraventricularis, e анат.
paravertebralis | paravertebralis, e анат.
Paraxinum | Paraxinum, i n
Parazinum | Parazinum, i n
Parazonum | Parazonum, i n
Parca | Parca, ae f
parce | parce adv.
Parekinum | Parekinum, i n
parenchyma | parenchyma, atis n
parens | I parens, entis m
parentalia | parentalia, ium n
parenteralis | parenteralis, e анат.
parentes | parentes, ium m
pareo | pareo, ui, itum, ere impers.
Pargitanum | Pargitanum, i n
paries | paries, etis m
parietalis | parietalis, e анат.
parietinae | parietinae, arum f
parietomastoideus | parietomastoideus, a, um анат.
parietooccipitalis | parietooccipitalis, e анат.
parietopontinus | parietopontinus, a, um анат.
pario | pario, peperi, partum, ere part.
Paris | Paris, idis m
Parisii | Parisii, orum m
pariter | pariter adv.
Parkanum | Parkanum, i n
Parkazinum | Parkazinum, i n
Parkisanum | Parkisanum, i n
Parkopanum | Parkopanum, i n
parma | parma, ae f
parmati | parmati, orum m
parmula | parmula, ae f
Parnas | Parna(s)sos (-us), i m
Parnatum | Parnatum, i n
Parnitenum | Parnitenum, i n
paro | I paro, (avi), atum, are m
parochus | parochus, i m
parodontium | parodontium, i n
parodontopathia | parodontopathia, ae f
parodontosis | parodontosis, is f
Parodynum | Parodynum, i n
paroecia | paroecia, ae f
Paromomycinum | Paromomycinum, i n
paroophoron | paroophoron, i n
Paros | Paros (-us), i f
parotideomassetericus | parotideomassetericus, a, um анат.
parotis | parotis, idis f
paroxysmalis | paroxysmalis, e мед.
parra | parra, ae f
parricida | parricida, ae m
parricidium | parricidium, i n
pars | I pars, partis f
Parsidolum | Parsidolum, i n
parsimonia | parsimonia, ae f
Parstelinum | Parstelinum, i n
parta | parta, orum n
Parthenon | Parthenon, onis m
Parthenope | Parthenope, es f
Parthi | Parthi, orum m
particula | particula, ae f
partim | partim см.
partite | partite adv.
partitio | partitio, onis f
parturio | parturio, ivi (ii), --, ire поэт.
partus | partus, us m
parum | parum adv.
parumper | parumper adv.
parunculus | parunculus, i m
parva | parva, ae f
parvitas | parvitas, atis f
parvum | parvum, i, n
parvus | I parvus, a, um compar.
Pasalicylum | Pasalicylum, i n
pascua | pascua, orum n
Pasiphaa | Pasiphaa, ae f
Pasomycinum | Pasomycinum, i n
passer | passer, eris m
passerculus | passerculus, i m
Passiflora | Passiflora бот.
passim | passim adv.
passum | I passum, i n
passus | I passus, a, um part.
pasta | pasta, ae f
pastillum | pastillum, i n
pastillus | pastillus, i m
Pastinacinum | Pastinacinum, i n
pastio | pastio, onis f
pastor | pastor, oris m
pastus | pastus, us m
Patavium | Patavium, i n
patefactio | patefactio, onis f
patefio | patefio, factus sum, fieri pass.
patella | patella, ae f
patellaris | patellaris, e анат.
patena | patena, ae f
patenter | patenter adv.
pater | pater, tris m
patera | patera, ae f
paternus | paternus, a, um поэт.
pathogenesis | pathogenesis, is f
pathogenus | pathogenus, a, um мед.
pathologia | pathologia, ae f
pathologicus | pathologicus, a, um мед.
patibulum | patibulum, i n
patiens | patiens, entis поэт.
patienter | patienter adv.
patientia | patientia, ae f
patina | patina (patena), ae f
patinatio | patinatio, onis f
patinus | patinus, i m
patior | patior, passus sum, pati поэт.
patrator | patrator, oris m
patria | patria, ae f
patricia | patricia, ae f
patricida | patricida, ae m
patricius | I patricius, a, um m
patrimonium | patrimonium, i n
patrocinium | patrocinium, i n
Patrocles | Patrocles, is m
patrona | patrona, ae f
patronus | patronus, i m
patronuus | patronuus, i m
patruelis | patruelis, e поэт.
patruus | I patruus, a, um m
pauca | pauca, orum n
pauci | pauci, orum m
pauciflorus | pauciflorus, a, um биолог.
paucifolius | paucifolius, a, um биолог.
paucitas | paucitas, atis f
paucus | paucus, a, um pl.
paulatim | paulatim (paullatim) adv.
paulisper | paulisper (paullisper) adv.
paulo | paulo adv.
paululum | I paululum adv.
paulum | I paulum adv.
paulus | I paulus (paullus), a, um m
pauper | pauper, eris поэт.
pauperies | pauperies, ei f
paupertas | paupertas, atis f
Pausanias | Pausanias, ae m
pausea | pausea (pausia), ae f
Pavesthesinum | Pavesthesinum, i n
pavide | pavide adv.
pavimentum | pavimentum, i n
pavo | pavo, onis m
pavor | pavor, oris m
pax | pax, pacis f
Pecazinum | Pecazinum, i n
peccatum | peccatum, i n
peccatus | peccatus, us m
pecten | I pecten, inis m
pectinatus | pectinatus, a, um анат.
pectineus | pectineus, a, um анат.
Pectolum | Pectolum, i n
pectoralis | pectoralis, e анат.
pectus | pectus, oris n
Pectussinum | Pectussinum, i n
pecu | pecu, us n
pecuaria | pecuaria, orum n
pecuarius | I pecuarius, a, um m
peculator | peculator, oris m
peculatus | peculatus, us m
peculium | peculium, i n
pecunia | pecunia, ae f
pecus | I pecus, oris n
pedalis | I pedalis, e анат.
pedes | pedes, itis m
pedetemtim | pedetemtim (pedetemptim) adv.
pediaeus | pediaeus, a, um анат.
pedica | pedica, ae f
pediculus | pediculus, i m
pedidius | pedidius, a, um анат.
pedisequa | pedisequa, ae f
pedisequus | I pedisequus, a, um m
peditatus | peditatus, us m
Pedrolonum | Pedrolonum, i n
pedum | pedum, i n
peduncularis | peduncularis, e анат.
pedunculus | pedunculus, i m
Peflavitum | Peflavitum, i n
Pegasiformes | Pegasiformes, ium f
Pegasos | Pegasos (-us), i m
pegma | pegma, atis n
Pehanormum | Pehanormum, i n
pejor | pejor compar.
pejus | pejus compar.
pelagus | pelagus, i n
Pelasgi | Pelasgi, orum m
Pelazidum | Pelazidum, i n
Pelentanum | Pelentanum, i n
Peleus | Peleus (= Pele^us), ei (eos) m
Pelides | Pelides, ae m
Pelion | Pelion, i n
Pella | Pella, ae f
Pellagraminum | Pellagraminum, i n
pellectio | pellectio, onis f
pellicula | pellicula, ae f
pellis | pellis, is f
pello | pello, pepuli, pulsum, ere поэт.
pellucidus | pellucidus, a, um анат.
Pelminum | Pelminum, i n
Peloidinum | Peloidinum, i n
Peloidodestillatum | Peloidodestillatum, i n
Peloninum | Peloninum, i n
Peloponnesos | Peloponnesos (-us), i f
Pelops | Pelops, opis m
peloris | peloris, idis f
pelta | pelta, ae f
peltastae | peltastae, arum m
pelusia | pelusia, ae f
pelvinus | pelvinus, a, um анат.
Pelviranum | Pelviranum, i n
pelvis | pelvis, is f
Pemalinum | Pemalinum, i n
pemma | pemma, ae f
Penadurum | Penadurum, i n
penates | penates, ium m
Penbritinum | Penbritinum, i n
pendeo | pendeo, pependi, --, ere поэт.
Pendeponum | Pendeponum, i n
Pendiomidum | Pendiomidum, i n
pendulus | pendulus, a, um поэт.
pene | pene adv.
Penelopa | Penelopa, ae f
penes | penes praep.
Penesterum | Penesterum, i n
Penethacillinum | Penethacillinum, i n
penetralia | penetralia, ium n
penicilli | penicilli, orum m
Penicillinasum | Penicillinasum, i n
Penicillinum | Penicillinum, i n
penicillum | penicillum, i n
penicillus | penicillus, i m
peniciter | peniciter adv.
peninsula | peninsula, ae f
penis | penis, is m
penitus | penitus adv.
penna | penna, ae f
pennula | pennula, ae f
pensio | pensio, onis f
Penstaphocidum | Penstaphocidum, i n
pensum | pensum, i n
Pentabismolum | Pentabismolum, i n
Pentacidum | Pentacidum, i n
Pentacinum | Pentacinum, i n
pentadactylus | pentadactylus, a, um биолог.
Pentafinum | Pentafinum, i n
Pentalginum | Pentalginum, i n
Pentalongum | Pentalongum, i n
Pentalum | Pentalum, i n
Pentamethazenum | Pentamethazenum, i n
Pentamethazolum | Pentamethazolum, i n
Pentamethonum | Pentamethonum, i n
Pentaminum | Pentaminum, i n
Pentamylonum | Pentamylonum, i n
Pentanitritum | Pentanitritum, i n
Pentanitrolum | Pentanitrolum, i n
pentaradialis | pentaradialis, e биолог.
Pentarylum | Pentarylum, i n
Pentarytum | Pentarytum, i n
Pentavitolum | Pentavitolum, i n
Pentazolum | Pentazolum, i n
Pentetrazolum | Pentetrazolum, i n
Penthranum | Penthranum, i n
Pentilenum | Pentilenum, i n
Pentitratum | Pentitratum, i n
Pentonum | Pentonum, i n
Pentovitum | Pentovitum, i n
Pentoxylum | Pentoxylum, i n
Pentoxyverinum | Pentoxyverinum, i n
Pentralum | Pentralum, i n
Pentranum | Pentranum, i n
Pentrazolum | Pentrazolum, i n
Pentrexum | Pentrexum, i n
Pentrexylum | Pentrexylum, i n
Pentritolum | Pentritolum, i n
Pentritta | Pentritta, ae f
Pentylentetrazolum | Pentylentetrazolum, i n
Pentylum | Pentylum, i n
penuria | penuria, ae f
penus | I penus, oris n
peplum | peplum, i n
peplus | peplus, i m
Pepsacidum | Pepsacidum, i n
Pepsaminum | Pepsaminum, i n
Pepsinum | Pepsinum, i n
Pepulsanum | Pepulsanum, i n
per | per praep.
pera | pera, ae f
Peraconum | Peraconum, i n
peractio | peractio, onis f
peracute | peracute adv.
peradolescens | peradolescens, entis m
peradolescentulus | peradolescentulus, i m
peraeque | peraeque adv.
Peragitum | Peragitum, i n
perago | perago, egi, actum, ere юр.
peragratio | peragratio, onis f
peramanter | peramanter adv.
perambulo | perambulo, avi, atum, are поэт.
Perandrenum | Perandrenum, i n
peranguste | peranguste adv.
peraro | peraro, avi, atum, are поэт.
perattente | perattente adv.
perbelle | perbelle adv.
perbene | perbene adv.
perbenigne | perbenigne adv.
perbreviter | perbreviter adv.
perca | perca, ae f
Percainum | Percainum, i n
Percaminum | Percaminum, i n
percelebro | percelebro, avi, atum, are pass.
perceleriter | perceleriter adv.
perceptio | perceptio, onis f
Perchlorethylenum | Perchlorethylenum, i n
percipio | percipio, cepi, ceptum, ere pf.
percommode | percommode adv.
percontatio | percontatio, onis f
percontator | percontator, oris m
Percortenum | Percortenum, i n
percursatio | percursatio, onis f
percursio | percursio, onis f
percussio | percussio, onis f
percussor | percussor, oris m
percussus | percussus, us m
perdifficiliter | perdifficiliter adv.
perdiligenter | perdiligenter adv.
perdisco | perdisco, didici, --, ere pf.
perdiserte | perdiserte adv.
perdite | perdite adv.
perditor | perditor, oris m
perdiu | perdiu adv.
perdix | perdix, icis m
perdo | perdo, didi, ditum, ere поэт.
perduco | perduco, duxi, ductum, ere поэт.
perductor | perductor, oris m
perduellio | perduellio, onis f
perduellis | perduellis, is m
peregre | peregre adv.
peregrina | peregrina, ae f
peregrinatio | peregrinatio, onis f
peregrinator | peregrinator, oris m
peregrinitas | peregrinitas, atis f
peregrinus | I peregrinus, a, um m
pereleganter | pereleganter adv.
Pereminum | Pereminum, i n
perendie | perendie adv.
perennis | perennis, e биолог.
perennitas | perennitas, atis f
perexigue | perexigue adv.
perfacete | perfacete adv.
perfacile | perfacile adv.
perfecte | perfecte adv.
perfectio | perfectio, onis f
perfector | perfector, oris m
perfero | perfero, tuli, latum, ferre pass.
perfidia | perfidia, ae f
perfidiose | perfidiose adv.
perforaculum | perforaculum, i n
perforatio | perforatio, onis f
perforatus | perforatus, a, um анат.
perfuga | perfuga, ae m
perfugium | perfugium, i n
perfunctio | perfunctio, onis f
perfundo | perfundo, fudi, fusum, ere, pass.
Pergamum | Pergamum, i n
pergraviter | pergraviter adv.
perhonorifice | perhonorifice adv.
perhumaniter | perhumaniter adv.
Perhydritum | Perhydritum, i n
Perhydrolum | Perhydrolum, i n
perianalis | perianalis, e анат.
perianthium | perianthium, i n
periapicalis | periapicalis, e анат.
periappendicularis | periappendicularis, e анат.
periarterialis | periarterialis, e анат.
periarthritis | periarthritis, idis f
periarticularis | periarticularis, e анат.
periauricularis | periauricularis, e анат.
peribronchialis | peribronchialis, e анат.
pericardiacophrenicus | pericardiacophrenicus, a, um анат.
pericarditis | pericarditis, idis f
pericardium | pericardium, i n
perichondritis | perichondritis, idis f
perichondrium | perichondrium, i n
perichorioidealis | perichorioidealis, e анат.
Pericles | Pericles, is m
periclitatio | periclitatio, onis f
pericranium | pericranium, i n
periculose | periculose adv.
periculum | periculum, i n
perilympha | perilympha, ae f
perilymphaticus | perilymphaticus, a, um анат.
perimetritis | perimetritis, idis f
perimetrium | perimetrium, i n
perimo | perimo, emi, emptum (emtum), ere pass.
perimotio | perimotio, onis f
perimysium | perimysium, i n
perincommode | perincommode adv.
perinde | perinde adv.
perinealis | perinealis, e анат.
perinephritis | perinephritis, idis f
perineum | perineum, i n
perineuralis | perineuralis, e анат.
perineurium | perineurium, i n
periodontitis | periodontitis, idis f
periodontium | periodontium, i n
perionyx | perionyx, ycis f
periorbita | periorbita, ae f
periosteum | periosteum, i n
periostitis | periostitis, idis f
peripetasma | peripetasma, atis n
peripheria | peripheria, ae f
periphericus | periphericus, a, um анат.
Periploca | Periploca, ae f
Periplocinum | Periplocinum, i n
periscelis | periscelis, idis f
peristroma | peristroma, atis n
peristylum | peristylum, i n
perite | perite adv.
peritendineum | peritendineum, i n
peritia | peritia, ae f
peritoneoperinealis | peritoneoperinealis, e анат.
peritoneum | peritoneum, i n
peritonitis | peritonitis, idis f
Peritratum | Peritratum, i n
perivascularis | perivascularis, e анат.
periventricularis | periventricularis, e анат.
perjucunde | perjucunde adv.
perjurium | perjurium, i n
perlate | perlate adv.
perlectio | perlectio, onis f
perleviter | perleviter adv.
perlibenter | perlibenter adv.
perliberaliter | perliberaliter adv.
perluo | perluo, lui, lutum, ere pass.
permale | permale adv.
permansio | permansio, onis f
permissio | permissio, onis f
permissum | permissum, i n
permissus | permissus, us m
Permitilum | Permitilum, i n
permixte | permixte adv.
permixtim | permixtim adv.
permixtio | permixtio, onis f
permoleste | permoleste adv.
permulto | permulto adv.
permultum | permultum adv.
permutatio | permutatio, onis f
perna | perna, ae f
pernecesse | pernecesse adv.
pernicies | pernicies, ei f
perniciose | perniciose adv.
pernicitas | pernicitas, atis f
Pernovinum | Pernovinum, i n
pero | pero, onis m
perofficiose | perofficiose adv.
Perolysenum | Perolysenum, i n
peronealis | peronealis, e анат.
peropportune | peropportune adv.
peroratio | peroratio, onis f
Perovexum | Perovexum, i n
peroxydum | peroxydum, i n
perparvum | perparvum adv.
perpaulum | perpaulum, i n
perpendicularis | perpendicularis, e анат.
perpendiculum | perpendiculum, i n
perperem | perperem adv.
perpessio | perpessio, onis f
perpetuitas | perpetuitas, atis f
Perphenanum | Perphenanum, i n
Perphenazinum | Perphenazinum, i n
perplexe | perplexe adv.
perpotatio | perpotatio, onis f
perquam | perquam adv.
perquisite | perquisite adv.
perraro | perraro adv.
perridicule | perridicule adv.
perrogatio | perrogatio, onis f
Persae | Persae, arum m
persaepe | persaepe adv.
persalse | persalse adv.
persalutatio | persalutatio, onis f
persancte | persancte adv.
Persantinum | Persantinum, i n
persapienter | persapienter adv.
perscienter | perscienter adv.
perscriptio | perscriptio, onis f
perscriptor | perscriptor, oris m
Persedonum | Persedonum, i n
Persephone | Persephone, es f
Persepolis | Persepolis, is f
persequor | persequor, secutus (sequutus) sum, sequi юр.
Perses | Perses, ae m
Perseus | Perseus (=Perse^us), ei (eos) m
perseveranter | perseveranter adv.
perseverantia | perseverantia, ae f
Persis | I Persis, idis (idos) f
persona | persona, ae f
perspicientia | perspicientia, ae f
perspicilia | perspicilia, ae f
perspicue | perspicue adv.
perspicuitas | perspicuitas, atis f
persto | persto, stiti, (statum), are поэт.
perstudiose | perstudiose adv.
persuadeo | persuadeo, suasi, suasum, ere impers.
persuasio | persuasio, onis f
persuasus | persuasus, us m
pertaedet | pertaedet, pertaesum est, ere impers.
pertento | pertento (pertempto), avi, atum, are поэт.
Perthidinum | Perthidinum, i n
pertica | pertica, ae f
pertinacia | pertinacia, ae f
pertinaciter | pertinaciter adv.
pertisum | pertisum (pertaesum) см.
pertractatio | pertractatio, onis f
Pertranquilum | Pertranquilum, i n
pertumultuose | pertumultuose adv.
perturbate | perturbate adv.
perturbatio | perturbatio, onis f
Pertussinum | Pertussinum, i n
pervarie | pervarie adv.
perveho | perveho, vexi, vectum, ere pass.
perverse | perverse adv.
perversitas | perversitas, atis f
pervesperi | pervesperi adv.
pervestigatio | pervestigatio, onis f
pervicacia | pervicacia, ae f
pervicaciter | pervicaciter adv.
pervigilatio | pervigilatio, onis f
pervigilium | pervigilium, i n
Pervitinum | Pervitinum, i n
pervium | pervium, i n
pes | pes, pedis m
pessime | pessime adv.
pessimus | pessimus, a, um adj.
pessum | pessum adv.
pestifere | pestifere adv.
pestilentia | pestilentia, ae f
pestis | pestis, is f
petaloideus | petaloideus, a, um биолог.
petalum | petalum, i n
Petidionum | Petidionum, i n
Petinimidum | Petinimidum, i n
petiolus | petiolus, i m
petitio | petitio, onis f
petitor | petitor, oris m
peto | peto, ivi (ii), itum, ere юр.
petoritum | petoritum, i n
petorritum | petorritum (petoritum), i n
petra | petra, ae f
petrooccipitalis | petrooccipitalis, e анат.
petrosquamosus | petrosquamosus, a, um анат.
petrosus | petrosus, a, um анат.
petrotympanicus | petrotympanicus, a, um анат.
petulanter | petulanter adv.
petulantia | petulantia, ae f
Peucedaninum | Peucedaninum, i n
Pevirosum | Pevirosum, i n
Pevitonum | Pevitonum, i n
Phaedra | Phaedra, ae f
Phaedrus | Phaedrus, i m
Phaethon | Phaethon, ontis m
phager | phager, gri m
phagocytus | phagocytus, i m
phalanga | phalanga, ae f
phalangitae | phalangitae, arum m
phalanx | phalanx, angis f
phalerae | phalerae, arum f
phallus | phallus, i m
Phanchinonum | Phanchinonum, i n
Phanoctalum | Phanoctalum, i n
Phanodormum | Phanodormum, i n
Phanquinonum | Phanquinonum, i n
Phanquonum | Phanquonum, i n
pharetra | pharetra, ae f
pharmaceutria | pharmaceutria, ae f
pharmacon | pharmacon, i n
pharmacopola | pharmacopola, ae m
pharmocopolium | pharmocopolium, i n
Pharmotalum | Pharmotalum, i n
Pharos | Pharos (-us), i f
Pharsalos | Pharsalos (-us), i f
pharyngeus | pharyngeus, a, um анат.
pharyngobasilaris | pharyngobasilaris, e анат.
pharynx | pharynx, yngis m
phaselus | phaselus (phaselos), i m
Phasis | Phasis, idis (idos) m
Phenacetinum | Phenacetinum, i n
Phenaconum | Phenaconum, i n
Phenadonum | Phenadonum, i n
Phenalginum | Phenalginum, i n
Phenaloinum | Phenaloinum, i n
Phenasalum | Phenasalum, i n
Phenatinum | Phenatinum, i n
Phenazonum | Phenazonum, i n
Phenedinum | Phenedinum, i n
Phenemalum | Phenemalum, i n
Phenerganum | Phenerganum, i n
Phenetamidum | Phenetamidum, i n
Phenforminum | Phenforminum, i n
Phenindaminum | Phenindaminum, i n
Phenindionum | Phenindionum, i n
Pheninum | Pheninum, i n
Pheniodolum | Pheniodolum, i n
Phenmetralinum | Phenmetralinum, i n
Phenmetrazinum | Phenmetrazinum, i n
Phenobarbitalum | Phenobarbitalum, i n
Phenobarbitonum | Phenobarbitonum, i n
Phenobolinum | Phenobolinum, i n
Phenocillinum | Phenocillinum, i n
Phenolphthaleinum | Phenolphthaleinum, i n
Phenolum | Phenolum, i n
Phenophanum | Phenophanum, i n
Phenopyrinum | Phenopyrinum, i n
Phenoquinum | Phenoquinum, i n
Phenoxazolum | Phenoxazolum, i n
Phenoxymethylpenicillinum | Phenoxymethylpenicillinum, i n
Phentanylum | Phentanylum, i n
Phentolaminum | Phentolaminum, i n
Phenylbutazonum | Phenylbutazonum, i n
Phenylephrinum | Phenylephrinum, i n
Phenylindandionum | Phenylindandionum, i n
Phenylinum | Phenylinum, i n
Phenylonum | Phenylonum, i n
Phenytoinum | Phenytoinum, i n
Phepranonum | Phepranonum, i n
Phethanolum | Phethanolum, i n
Phidias | Phidias, ae m
Philemon | Philemo(n), monis m
Philippi | Philippi, orum m
Philippus | Philippus, i m
philitia | philitia, orum n
Philoctetes | Philoctetes, ae m
Philodormum | Philodormum, i n
philologia | philologia, ae f
philologus | philologus, i m
Philopotamus | Philopotamus, i m
philosopha | philosopha, ae f
philosophe | philosophe adv.
philosophia | philosophia, ae f
philosophus | I philosophus, a, um m
philtrum | I philtrum, i n
philura | philura, ae f
philyra | philyra (philura), ae f
phimus | phimus, i m
phlebogramma | phlebogramma, atis n
phlebographia | phlebographia, ae f
phlebolithus | phlebolithus, i m
phlebolysis | phlebolysis, is f
phlebotomia | phlebotomia, ae f
phlebs | phlebs, phlebos n
phlegmone | phlegmone, es f
phlegmonosus | phlegmonosus, a, um мед.
Phobexum | Phobexum, i n
phoca | phoca, ae f
Phocaea | Phocaea, ae f
phoce | phoce, es f
Phocis | Phocis, idis (idos) f
Phoebe | Phoebe, es f
Phoebus | Phoebus, i m
Phoenix | I Phoenix, icis m
phonocaseta | phonocaseta, ae f
Phosphacolum | Phosphacolum, i n
phosphas | phosphas, atis m
Phosphoestrolum | Phosphoestrolum, i n
Phosphorus | Phosphorus, i m
Phosphothiaminum | Phosphothiaminum, i n
Phosphrenum | Phosphrenum, i n
photobiologia | photobiologia, ae f
photophobus | photophobus, a, um биолог.
photosyntheticus | photosyntheticus, a, um биолог.
phototrophus | phototrophus, a, um биолог.
Phrenazolum | Phrenazolum, i n
phrenicocolicus | phrenicocolicus, a, um анат.
phrenicolienalis | phrenicolienalis, e анат.
phrenicopleuralis | phrenicopleuralis, e анат.
phrenicus | phrenicus, a, um анат.
Phrenolonum | Phrenolonum, i n
Phrixus | Phrixus, i m
Phryges | Phryges, um m
Phrygia | Phrygia, ae f
Phthalazolum | Phthalazolum, i n
Phthazinum | Phthazinum, i n
Phthia | Phthia, ae f
phthisiater | phthisiater, tri m
phthisiatria | phthisiatria, ae f
Phthivazidum | Phthivazidum, i n
Phthoracizinum | Phthoracizinum, i n
Phthorafurum | Phthorafurum, i n
Phthorbenzotephum | Phthorbenzotephum, i n
Phthorocortum | Phthorocortum, i n
Phthorothanum | Phthorothanum, i n
Phthoruracilum | Phthoruracilum, i n
Phuturinum | Phuturinum, i n
phylarchus | phylarchus, i m
phyllophyton | phyllophyton, i n
Phyllopoda | Phyllopoda, orum n
phylogenesis | phylogenesis, is f
physica | I physica, ae f
physicalis | physicalis, e мед.
physice | physice adv.
physicus | I physicus, a, um m
physiognomon | physiognomon, onis m
physiologia | physiologia, ae f
physiologicus | physiologicus, a, um мед.
physiologus | physiologus, i m
physiotherapia | physiotherapia, ae f
Physolactinum | Physolactinum, i n
Phytinum | Phytinum, i n
Phytoferolum | Phytoferolum, i n
Phytoferrolactolum | Phytoferrolactolum, i n
Phytomelinum | Phytomelinum, i n
phytoncida | phytoncida, orum n
phytophagus | phytophagus, i m
phytotrophus | phytotrophus, a, um биолог.
piacularia | piacularia, ium n
piaculum | piaculum, i n
piamen | piamen, inis n
pica | pica, ae f
picaria | picaria, ae f
picea | picea, ae f
Picenum | Picenum, i n
Picoides | Picoides, is m
Pictones | Pictones, um m
pictor | pictor, oris m
pictura | pictura, ae f
picus | picus, i m
pie | pie adv.
pietas | pietas, atis f
piget | piget, uit (itum est), ere преим.
pigmentarius | pigmentarius, i m
pigmentum | pigmentum, i n
pignerator | pignerator, oris m
pignus | pignus, oris n
pigritia | pigritia, ae f
pila | I pila, ae f
pilanus | pilanus, i m
pilentum | pilentum, i n
pileulus | pileulus (pilleulus), i m
pileus | pileus (pilleus), i m
pilula | pilula, ae f
pilum | pilum, i n
pilus | I pilus, i m
Pimpinella | Pimpinella, ae f
pina | pina (pinna), ae f
Pinabinum | Pinabinum, i n
Pindarus | Pindarus, i m
Pindionum | Pindionum, i n
Pindus | Pindus, i m
pinea | pinea, ae f
pinealis | pinealis, e анат.
pinetum | pinetum, i n
pingue | pingue, is n
pinna | I pinna, ae f
pinnula | pinnula (pinula), ae f
pinoteres | pinoteres, ae m
Pinus | Pinus, i f
pinus | pinus, us f
Piofolinum | Piofolinum, i n
Pioxolum | Pioxolum, i n
pipa | pipa, ae f
Pipanolum | Pipanolum, i n
piper | piper, eris n
Piperascatum | Piperascatum, i n
Piperazatum | Piperazatum, i n
Piperazinum | Piperazinum, i n
piperitus | piperitus, a, um фармац.
Pipolphenum | Pipolphenum, i n
Pipradrolum | Pipradrolum, i n
Pipralum | Pipralum, i n
Piraeus | Piraeus, i m
Pirasulfonum | Pirasulfonum, i n
pirata | pirata, ae m
piratica | piratica, ae f
Piridrolum | Piridrolum, i n
piriformis | piriformis, e анат.
Pirilenum | Pirilenum, i n
Pirmazinum | Pirmazinum, i n
pirum | pirum, i n
pirus | pirus, i f
Pirvilum | Pirvilum, i n
piscator | piscator, oris m
piscatus | piscatus, us m
pisciculus | pisciculus, i m
piscina | piscina, ae f
piscinarius | piscinarius, i m
piscis | piscis, is m
pisiformis | pisiformis, e анат.
Pisistratus | Pisistratus, i m
pisohamatus | pisohamatus, a, um анат.
pisometacarpeus | pisometacarpeus, a, um анат.
pistor | pistor, oris m
pistrina | pistrina, ae f
pistrinum | pistrinum, i n
pistrix | pistrix, icis f
pisum | pisum, i n
Pitonum | Pitonum, i n
Pituglandolum | Pituglandolum, i n
Pituiganum | Pituiganum, i n
pituitarius | pituitarius, a, um анат.
Pituitrinum | Pituitrinum, i n
piuita | piuita, ae f
pius | pius, a, um ����.
pix | pix, picis f
placabilitas | placabilitas, atis f
placamen | placamen, inis n
placamentum | placamentum, i n
placate | placate adv.
placatio | placatio, onis f
placenta | I placenta, ae f
placeo | placeo, ui, itum, ere impers.
placide | placide adv.
placitum | placitum, i n
plaga | I plaga, ae f
plagiarius | plagiarius, i m
plagula | plagula, ae f
planctus | planctus, us m
plane | plane adv.
plango | plango, planxi, planctum, ere pass.
plangor | plangor, oris m
planguncula | planguncula, ae f
planitas | planitas, atis f
planitia | planitia, ae f
Planocainum | Planocainum, i n
planta | I planta, ae f
Plantago | Plantago, inis f
plantaria | plantaria, ium n
plantaris | I plantaris, e анат.
planum | planum, i n
planus | I planus, a, um m
Plaquenilum | Plaquenilum, i n
Plaquinolum | Plaquinolum, i n
plasma | plasma, atis n
Plasmocidum | Plasmocidum, i n
Plasmolum | Plasmolum, i n
plasticus | plasticus, a, um анат.
Plataeae | Plataeae, arum f
platalea | platalea, ae f
platanus | platanus, i f
platea | platea f
Plathelminthes | Plathelminthes, um f
Platon | Plato(n), onis m
Platonici | Platonici, orum m
platurus | platurus, a, um биолог.
Platydinum | Platydinum, i n
Platyphyllinum | Platyphyllinum, i n
platyphyllus | platyphyllus, a, um биолог.
platyrrhinus | platyrrhinus, a, um биолог.
platysma | platysma, atis n
plausor | plausor, oris m
plaustrum | plaustrum (plostrum), i n
plausus | plausus, us m
Plautus | Plautus, i m
Plavephinum | Plavephinum, i n
plebecula | plebecula, ae f
plebeja | plebeja, ae f
plebejus | I plebejus, a, um m
plebes | plebes, ei f
plebicola | plebicola, ae m
plebiscitum | plebiscitum, i n
plebs | plebs, plebis f
plecto | plecto, --, --, ere pass.
plectrum | plectrum, i n
Pleganginum | Pleganginum, i n
Plegomazinum | Plegomazinum, i n
Pleione | Pleione, es f
Plejades | Plejades, adum f
plene | plene adv.
pleraeque | pleraeque см.
plerique | plerique см.
plerumque | plerumque adv.
plerusque | plerusque, plereque, plerumque pl.
pleura | pleura, ae f
pleuritis | pleuritis, idis f
plexus | plexus, us m
plica | plica, ae f
plicatus | plicatus, a, um анат.
ploeres | ploeres арх.
ploratus | ploratus, us m
plosor | plosor, oris m
plostellum | plostellum, i n
plostrum | plostrum, i n
plosus | plosus, us m
pluma | pluma, ae f
Plumbum | Plumbum, i n
plumbum | plumbum, i n
pluo | pluo, plui ( арх.
plurimus | plurimus, a, um см.
plus | plus, pluris см.
pluteus | pluteus, i m
Pluton | Pluto(n), onis m
pluvia | pluvia, ae f
pneumaticus | pneumaticus, a, um анат.
pneumatosis | pneumatosis, is f
pneumolysis | pneumolysis, is f
pneumonectomia | pneumonectomia, ae f
pneumonia | pneumonia, ae f
pneumoperitoneum | pneumoperitoneum, i n
pneumosclerosis | pneumosclerosis, is f
pneumothorax | pneumothorax, acis m
pneumotomia | pneumotomia, ae f
Poa | Poa, ae f
pocillum | pocillum, i n
poculum | poculum, i n
podagra | podagra, ae f
podex | podex, icis m
podocarpus | podocarpus, a, um биолог.
Podophyllinum | Podophyllinum, i n
Podophyllum | Podophyllum, i n
Poecile | Poecile, es f
poema | poema, atis n
poena | poena, ae f
Poeni | Poeni, orum m
poenitentia | poenitentia, ae f
poeniteo | poeniteo (paeniteo), ui, --, ere impers.
poenitio | poenitio, onis f
poesis | poesis, is f
poeta | poeta, ae m
poetica | poetica, ae f
poetice | poetice adv.
poetria | poetria, ae f
pol | pol! interj.
Polamidonum | Polamidonum, i n
polaris | polaris, e анат.
Polcortoionum | Polcortoionum, i n
Polcortum | Polcortum, i n
Polemonium | Polemonium, i n
polenta | polenta, ae f
Polfamycinum | Polfamycinum, i n
Polfavenolum | Polfavenolum, i n
poliomyelitis | poliomyelitis, idis f
polite | polite adv.
politia | politia, ae f
pollex | pollex, icis m
pollicitatio | pollicitatio, onis f
pollicitura | pollicitura, i n
Pollux | Pollux, ucis m
Polocainum | Polocainum, i n
Polopyrina | Polopyrina, ae f
polus | I polus, i m
polyandria | polyandria, ae f
polyarthralgia | polyarthralgia, ae f
polyarthritis | polyarthritis, idis f
polyavitaminosis | polyavitaminosis, is f
Polybius | Polybius, i m
Polycidinum | Polycidinum, i n
Polycillinum | Polycillinum, i n
polycladus | polycladus, a, um биолог.
polycystosus | polycystosus, a, um мед.
polydactylia | polydactylia, ae f
polydactylus | polydactylus, a, um биолог.
polygamia | polygamia, ae f
polygamus | polygamus, a, um биолог.
Polyglucinum | Polyglucinum, i n
Polygonum | Polygonum, i n
polygynia | polygynia, ae f
Polyhymnia | Polyhymnia, ae f
Polymerolum | Polymerolum, i n
polyneuritis | polyneuritis, idis f
polyphagia | polyphagia, ae f
Polyphemos | Polyphemos (-us), i m
polyphosphas | polyphosphas, atis m
polyposis | polyposis, is f
polypterus | polypterus, a, um биолог.
polypus | I polypus, i m
polyrrhizus | polyrrhizus, a, um биолог.
polyuria | polyuria, ae f
Polyvinylpyrrolidonum | Polyvinylpyrrolidonum, i n
polyvitaminicus | polyvitaminicus, a, um фармац.
polyvitaminosus | polyvitaminosus, a, um фармац.
polyvitaminum | polyvitaminum, i n
Polyzimum | Polyzimum, i n
pomarium | pomarium, i n
pomarius | I pomarius, a, um m
pomerium | pomerium, i n
pomoerium | pomoerium (pomerium), i n
pompa | pompa, ae f
Pompejani | Pompejani, orum m
Pompeji | Pompeji, orum m
pompilus | pompilus, i m
pomum | pomum, i n
pomus | pomus, i f
Pondexum | Pondexum, i n
pondus | pondus, eris n
pone | I pone adv.
pono | I pono, posui, positum, ere pass.
ponticulus | ponticulus, i m
pontifex | pontifex, icis m
pontificatus | pontificatus, us m
ponto | ponto, onis m
pontus | I pontus, i m
popa | popa, ae m
popellus | popellus, i m
popina | popina, ae f
popino | popino, onis m
poples | I poples, itis m
popliteus | popliteus, a, um анат.
poplus | poplus, i m
populares | populares, ium m
popularis | I popularis, e m
populariter | populariter adv.
populatio | populatio, onis f
populator | populator, oris m
populiscitum | populiscitum, i n
populo | populo, avi, atum, are поэт.
populus | I populus, i m
porca | porca, ae f
porcus | porcus, i m
porrectio | porrectio, onis f
porrectus | porrectus, a, um поэт.
porrigo | I porrigo, inis f
porro | porro adv.
porrum | porrum, i n
porta | porta, ae f
portalis | portalis, e анат.
portatio | portatio, onis f
portendo | portendo, tendi, tentum, ere pass.
portentum | portentum, i n
porticula | porticula, ae f
porticus | porticus, us f
portio | portio, onis f
portitor | I portitor, oris m
portocavalis | portocavalis, e анат.
portorium | portorium, i n
portula | portula, ae f
portus | portus, us m
porus | porus, i m
posco | posco, poposci, --, ere pass.
posea | posea, ae f
Posedrinum | Posedrinum, i n
posia | posia, ae f
positio | positio, onis f
positor | positor, oris m
positus | I positus, a, um m
possessio | I possessio, onis f
possessiuncula | possessiuncula, ae f
possessor | possessor, oris m
possideo | possideo, sedi, sessum, ere поэт.
post | I post adv.
post-hac | post-hac adv.
post-haec | post-haec adv.
postcentralis | postcentralis, e анат.
postea | postea adv.
posteaquam | posteaquam conj.
postembryonalis | postembryonalis, e биолог.
posteri | posteri, orum m
posterior | posterior, ius compar.
posteritas | posteritas, atis f
posterius | posterius adv.
postero | postero adv.
posterolateralis | posterolateralis, e анат.
posteromedialis | posteromedialis, e анат.
posterus | posterus, а, um compar.
postgeniti | postgeniti, orum m
posthaemorrhagicus | posthaemorrhagicus, a, um мед.
posticum | posticum, i n
postilio | postilio, onis f
postis | postis, is m
postliminium | postliminium, i n
postmodo | postmodo adv.
postmodum | postmodum adv.
postmoerium | postmoerium, i n
postnatalis | postnatalis, e биолог.
postprincipia | postprincipia, orum n
postquam | postquam conj.
postremo | postremo adv.
postremum | postremum adv.
postremus | postremus, a, um superl.
postridie | postridie adv.
postsynapticus | postsynapticus, a, um биолог.
postulatio | postulatio, onis f
postulatum | postulatum, i n
postulatus | postulatus, us m
postulo | postulo, avi, atum, are юр.
postumus | postumus, a, um superl.
postus | postus, a, um см.
potatio | potatio, onis f
potens | potens, entis поэт.
potentatus | potentatus, us m
potenter | potenter adv.
potentia | potentia, ae f
Potentilla | Potentilla, ae f
potestas | potestas, atis f
potio | potio, onis f
potior | I potior, itus sum, iri compar.
potis | potis, e compar.
potissimum | potissimum adv.
potissimus | potissimus, а, um superl.
potius | potius adv.
potor | potor, oris m
potulenta | potulenta, orum n
potus | I potus, a, um part.
Povanum | Povanum, i n
Povanylum | Povanylum, i n
Practololum | Practololum, i n
prae | prae praep.
praebeo | praebeo, bui, bitum, ere поэт.
praebitor | praebitor, oris m
praecentio | praecentio, onis f
praecentralis | praecentralis, e биолог.
praeceps | I praeceps adv.
praeceptio | praeceptio, onis f
praeceptor | praeceptor, oris m
praeceptrix | praeceptrix, icis f
praeceptum | praeceptum, i n
praecipitatus | praecipitatus, a, um хим.
praecipito | praecipito, avi, atum, are поэт.
praecipue | praecipue adv.
praecipuum | praecipuum, i n
praecise | praecise adv.
praecisio | praecisio, onis f
praeclare | praeclare adv.
praeco | praeco, onis m
praeconium | praeconium, i n
praecordia | praecordia, orum n
praecursio | praecursio, onis f
praecursor | praecursor, oris m
praeda | praeda, ae f
praedatio | praedatio, onis f
praedator | praedator, oris m
praediator | praediator, oris m
praedicatio | praedicatio, onis f
praedictio | praedictio, onis f
praedictum | praedictum, i n
praediolum | praediolum, i n
praedium | praedium, i n
praedo | praedo, onis m
praefatio | praefatio, onis f
praefectura | praefectura, ae f
praefectus | I praefectus, a, um part.
praefero | praefero, tuli, latum, ferre pass.
praefor | praefor, fatus sum, ari поэт.
praefracte | praefracte adv.
Praegnantolum | Praegnantolum, i n
Praegninum | Praegninum, i n
praegressio | praegressio, onis f
praegressus | praegressus, us m
praegustator | praegustator, oris m
praejudicatum | praejudicatum, i n
praejudicium | praejudicium, i n
praelum | praelum, i n
praemandata | praemandata, orum n
praemeditatio | praemeditatio, onis f
praemium | praemium, i n
praemolestia | praemolestia, ae f
praemonitus | praemonitus, us m
Praeneste | Praeneste, is n
Praenitronum | Praenitronum, i n
praenomen | praenomen, inis n
praenotio | praenotio, onis f
praenuntia | praenuntia, ae f
praenuntius | I praenuntius, a, um m
praeoccupatio | praeoccupatio, onis f
praeparatio | praeparatio, onis f
praeparatum | praeparatum, i n
Praephysonum | Praephysonum, i n
praepositio | praepositio, onis f
praepostere | praepostere adv.
praepropere | praepropere adv.
praerogativa | praerogativa, ae f
praerogativus | praerogativus, a, um юр.
praerupta | praerupta, orum n
praes | praes, praedis m
praesaepe | praesaepe, is n
praesagitio | praesagitio, onis f
praesagium | praesagium, i n
praescriptio | praescriptio, onis f
praescriptum | praescriptum, i n
praesensio | praesensio, onis f
praesentia | praesentia, ae f
praesertim | praesertim adv.
praeses | I praeses, idis m
praesidium | praesidium, i n
praestantia | praestantia, ae f
praestes | praestes, itis m
praestigator | praestigator, oris m
praestigiae | praestigiae, arum f
praesto | I praesto adv.
praestruo | praestruo, struxi, structum, ere поэт.
praesultator | praesultator, oris m
praesuo | praesuo, (sui), sutum, ere поэт.
praeter | I praeter adv.
praeterea | praeterea adv.
praeterfero | praeterfero, tuli, latum, ferre pass.
praetermissio | praetermissio, onis f
praetervectio | praetervectio, onis f
praetexta | praetexta, ae f
praetextum | praetextum, i n
praetextus | praetextus, us m
praetor | praetor, oris m
praetorium | praetorium, i n
praetorius | I praetorius, i m
praetura | praetura, ae f
praevaricatio | praevaricatio, onis f
praevaricator | praevaricator, oris m
praeveho | praeveho, vexi, vectum, ere pass.
praeverto | praeverto (praevorto), verti (vorti), versum (vorsum), ere pass.
Pramolanum | Pramolanum, i n
prandium | prandium, i n
Pranonum | Pranonum, i n
pratulum | pratulum, i n
pratum | pratum, i n
prave | prave adv.
pravitas | pravitas, atis f
Praxitenum | Praxitenum, i n
Praxtiteles | Praxtiteles, is (i) m
Prazinum | Prazinum, i n
precatio | precatio, onis f
precentralis | precentralis, e анат.
preciae | preciae, arum f
precordium | precordium, i n
Precortalonum | Precortalonum, i n
Precortalum | Precortalum, i n
precuneus | precuneus, i m
Predionum | Predionum, i n
Prednelanum | Prednelanum, i n
Prednisolonum | Prednisolonum, i n
Prednisonum | Prednisonum, i n
Pregneninolonum | Pregneninolonum, i n
Pregnoralum | Pregnoralum, i n
prehallux | prehallux, ucis m
preinterparietalis | preinterparietalis, e анат.
prelaryngicus | prelaryngicus, a, um анат.
Preludinum | Preludinum, i n
prelum | prelum, i n
premolaris | premolaris, e анат.
Prenolonum | Prenolonum, i n
prensatio | prensatio, onis f
Prenylaminum | Prenylaminum, i n
preoccipitalis | preoccipitalis, e анат.
prepatellaris | prepatellaris, e анат.
Prephysonum | Prephysonum, i n
preputialis | preputialis, e анат.
preputium | preputium, i n
prepyloricus | prepyloricus, a, um анат.
presacralis | presacralis, e анат.
Presidonum | Presidonum, i n
Presinolum | Presinolum, i n
Presocylum | Presocylum, i n
Presolisinum | Presolisinum, i n
presse | presse adv.
Pressedinum | Pressedinum, i n
pressio | pressio, onis f
pressor | pressor, oris m
pressus | I pressus, a, um m
Presurenum | Presurenum, i n
pretectalis | pretectalis, e анат.
pretiose | pretiose adv.
pretiosus | pretiosus, a, um поэт.
pretium | pretium, i n
pretrachealis | pretrachealis, e анат.
prevertebralis | prevertebralis, e анат.
prex | prex, precis f
Priamus | Priamus, i m
Priapus | Priapus, i m
pridem | pridem adv.
pridie | pridie adv.
Primachinum | Primachinum, i n
Primaquinum | Primaquinum, i n
primarius | primarius, a, um биолог.
Primates | Primates, um m
Primavitum | Primavitum, i n
primitiae | primitiae, arum f
primo | primo adv.
Primogynum | Primogynum, i n
Primonum | Primonum, i n
primordium | primordium, i n
primum | I primum adv.
primus | primus, a, um superl.
princeps | princeps, ipis pl.
principatus | principatus, us m
principialis | principialis, e анат.
principium | principium, i n
Priodaxum | Priodaxum, i n
prior | prior, prius compar.
prisce | prisce adv.
priscus | priscus, a, um поэт.
prisma | prisma, atis n
pristis | pristis, is (поэт. pistrix, icis) f
prius | prius adv.
priusquam | priusquam conj.
privatim | privatim adv.
privatio | privatio, onis f
privigna | privigna, ae f
privignus | privignus, i m
privilegium | privilegium, i n
Privinum | Privinum, i n
prnemunitio | prnemunitio, onis f
pro | I pro praep.
proagorus | proagorus, i m
proavus | proavus, i m
probabilitas | probabilitas, atis f
probabiliter | probabiliter adv.
probatio | probatio, onis, f
probator | probator, oris m
probe | probe adv.
probitas | probitas, atis f
proboscis | proboscis, idis f
probrum | probrum, i n
procacitas | procacitas, atis f
procaciter | procaciter adv.
Procainamidum | Procainamidum, i n
Procainum | Procainum, i n
Procalmadiolum | Procalmadiolum, i n
Procalmum | Procalmum, i n
Procardilum | Procardilum, i n
procaryota | procaryota, orum n
Procas | Proca(s), ae m
procella | procella, ae f
procer | procer, eris m
procere | procere adv.
proceritas | proceritas, atis f
procerus | procerus, a, um анат.
processio | processio, onis f
processus | I processus, us m
Prochlorpemazinum | Prochlorpemazinum, i n
Prochlorpermazinum | Prochlorpermazinum, i n
Procholonum | Procholonum, i n
Procillinum | Procillinum, i n
procinctus | procinctus, us m
proclamator | proclamator, oris m
proclive | proclive (proclivi) adv.
proclivitas | proclivitas, atis f
proconsul | proconsul, sulis m
proconsulatus | proconsulatus, us m
Procortanum | Procortanum, i n
procrastinatio | procrastinatio, onis f
procreatio | procreatio, onis f
procreator | procreator, oris m
procreatrix | procreatrix, icis f
Procrustes | Procrustes, ae m
proctalgia | proctalgia, ae f
proctectomia | proctectomia, ae f
proctitis | proctitis, idis f
proctologus | proctologus, i m
proctopexia | proctopexia, ae f
proctorrhagia | proctorrhagia, ae f
proctospasmus | proctospasmus, i m
proctostenosis | proctostenosis, is f
proctostomia | proctostomia, ae f
procul | procul adv.
Procuranum | Procuranum, i n
procuratio | procuratio, onis f
procurator | procurator, oris m
procuratrix | procuratrix, icis f
procurro | procurro, cucurri (curri), cursum, ere воен.
procursatio | procursatio, onis f
procursator | procursator, oris m
procursus | procursus, us m
procus | procus, i m
Procytoxum | Procytoxum, i n
Prodiabenum | Prodiabenum, i n
prodictator | prodictator, oris m
prodige | prodige adv.
prodigentia | prodigentia, ae f
prodigialiter | prodigialiter adv.
Prodigiosanum | Prodigiosanum, i n
prodigium | prodigium, i n
prodigus | prodigus, a, um поэт.
proditio | proditio, onis f
proditor | proditor, oris m
prodo | prodo, didi, ditum, ere поэт.
Prodormolum | Prodormolum, i n
Prodormum | Prodormum, i n
Prodoxum | Prodoxum, i n
prodromus | prodromus, i m
producte | producte adv.
productio | productio, onis f
proeliator | proeliator, oris m
proelium | proelium, i n
profanus | profanus, a, um поэт.
profectio | profectio, onis f
profecto | profecto adv.
profectus | profectus, us m
Profecundinum | Profecundinum, i n
profero | profero, tuli, latum, ferre воен.
professio | professio, onis f
professor | professor, oris m
profligator | profligator, oris m
profluens | I profluens, entis n
profluenter | profluenter adv.
profluentia | profluentia, ae f
profluvium | profluvium, i n
profore | profore inf.
profugus | I profugus, a, um m
profundo | profundo, fudi, fusum, ere pass.
profundum | profundum, i n
profundus | profundus, a, um поэт.
profuse | profuse adv.
profusus | profusus, a, um мед.
Progelanum | Progelanum, i n
progener | progener, eri m
progenia | progenia, ae f
progenies | progenies, ei f
progenitor | progenitor, oris m
Progesteroidum | Progesteroidum, i n
Progestinum | Progestinum, i n
Progestoralum | Progestoralum, i n
prognathia | prognathia, ae f
prognatismus | prognatismus, i m
prognosis | prognosis, is f
prognostica | prognostica, orum n
progrediens | progrediens, entis мед.
progressio | progressio, onis f
progressivus | progressivus, a, um мед.
progressus | progressus, us m
Proguanidum | Proguanidum, i n
Proguanilum | Proguanilum, i n
Progynonum | Progynonum, i n
proh | proh! interj.
prohibeo | prohibeo, bui, bitum, ere воен.
prohibitio | prohibitio, onis f
proinde | proinde adv.
projectio | projectio, onis f
projicio | projicio, jeci, jectum, ere pass.
Prolactinum | Prolactinum, i n
prolapsio | prolapsio, onis f
prolapsus | prolapsus, us m
prolatio | prolatio, onis f
proles | proles, is f
proletarius | proletarius, i m
prolixe | prolixe adv.
Prolixinum | Prolixinum, i n
proluo | proluo, lui, lutum, ere поэт.
prolusio | prolusio, onis f
Prolutonum | Prolutonum, i n
proluvies | proluvies, ei f
Promactilum | Promactilum, i n
Promazinamidum | Promazinamidum, i n
Promazinonum | Promazinonum, i n
Promazinum | Promazinum, i n
Promedolum | Promedolum, i n
Promeranum | Promeranum, i n
promeritum | promeritum, i n
Promethazinum | Promethazinum, i n
Prometheus | Prometheus (=Promethe^us), ei (eos) m
prominentia | prominentia, ae f
Promiodolum | Promiodolum, i n
promisce | promisce (promiscue) adv.
promissio | promissio, onis f
promissor | promissor, oris m
promissum | promissum, i n
promissus | promissus, a, um поэт.
promontorium | I promontorium n
promoveo | promoveo, movi, motum, ere воен.
prompte | prompte adv.
promptuarium | promptuarium, i n
promptus | I promptus, a, um m
promulgatio | promulgatio, onis f
promulsis | promulsis, idis f
promunturium | promunturium, i n
promus | promus, i m
pronatio | pronatio, onis f
pronator | pronator, oris m
prone | prone adv.
pronephros | pronephros, i m
pronepos | pronepos, otis m
proneptis | proneptis, is f
Pronestylum | Pronestylum, i n
Pronetalolum | Pronetalolum, i n
pronoea | pronoea, ae f
pronominatio | pronominatio, onis f
Prontalbinum | Prontalbinum, i n
Prontalinum | Prontalinum, i n
Prontamidum | Prontamidum, i n
Prontoinum | Prontoinum, i n
pronuba | pronuba, ae f
pronuntiatio | pronuntiatio, onis f
pronuntiator | pronuntiator, oris m
pronuntiatum | pronuntiatum, i n
pronuntio | pronuntio, avi, atum, are юр.
pronurus | pronurus, us f
pronus | pronus, a, um поэт.
prooemium | prooemium, i n
propaedeutica | propaedeutica, ae f
propagatio | propagatio, onis f
propagator | propagator, oris m
propago | I propago, avi, atum, are f
propalam | propalam adv.
Propaminum | Propaminum, i n
Propanididum | Propanididum, i n
Propapheninum | Propapheninum, i n
propatulum | I propatulum, i n
Propazinum | Propazinum, i n
prope | I prope adv.
propediem | propediem adv.
propemodum | propemodum adv.
propense | propense adv.
propensio | propensio, onis f
properanter | properanter adv.
properantia | properantia, ae f
properatio | properatio, onis f
properato | properato adv.
propere | propere adv.
Propericiazinum | Propericiazinum, i n
Propertius | Propertius, i m
prophasis | prophasis, is f
propinquitas | propinquitas, atis f
propior | propior, ius compar.
propius | propius adv.
propoma | propoma, ae f
propono | propono, posui, positum, ere pass.
Propontis | Propontis, idis (idos) f
proportio | proportio, onis f
propositio | propositio, onis f
propositum | propositum, i n
propraetor | propraetor, oris m
proprie | proprie adv.
proprietas | proprietas, atis f
propter | I propter adv.
propterea | propterea adv.
propudium | propudium, i n
propugnaculum | propugnaculum, i n
propugnatio | propugnatio, onis f
propugnator | propugnator, oris m
propulsatio | propulsatio, onis f
propylaea | propylaea, orum n
Propyliodonum | Propyliodonum, i n
Propylixum | Propylixum, i n
Propylsympatolum | Propylsympatolum, i n
proquaestore | proquaestore (= pro quaestore) m
prora | prora, ae f
prorogatio | prorogatio, onis f
prorsus | prorsus ( арх.
prorumpo | prorumpo, rupi, ruptum, ere pass.
prosa | prosa, ae f
prosapia | prosapia, ae f
proscenium | proscenium, i n
proscriptio | proscriptio, onis f
prosecta | prosecta, orum n
prosencephalon | prosencephalon, i n
Proseptinum | Proseptinum, i n
Proserinum | Proserinum, i n
Proserpina | Proserpina, ae f
prosocer | prosocer, eri m
prospectus | prospectus, us m
prospera | prospera, orum n
prospere | prospere adv.
prosperitas | prosperitas, atis f
prosperus | prosperus, a, um поэт.
prospicientia | prospicientia, ae f
Prospidinum | Prospidinum, i n
Prostaphlinum | Prostaphlinum, i n
prostata | prostata, ae f
prostaticus | prostaticus, a, um анат.
prostoma | prostoma, atis n
Prostrumilum | Prostrumilum, i n
Protandrenum | Protandrenum, i n
Protargolum | Protargolum, i n
protenus | protenus (protinus) adv.
protero | protero, trivi, tritum, ere поэт.
proterve | proterve adv.
protervitas | protervitas, atis f
Proteus | Proteus (=Prote^us), ei (eos) m
prothrombinum | prothrombinum, i n
protinus | protinus adv.
Protobranchia | I Protobranchia, orum n
protoplasma | protoplasma, atis n
Protozoa | Protozoa, orum n
protuberantia | protuberantia, ae f
proturbo | proturbo, avi, atum, are поэт.
prout | prout conj.
proveho | proveho, vexi, vectum, ere pass.
proventus | proventus, us m
proverbium | proverbium, i n
providenter | providenter adv.
providentia | providentia, ae f
provincia | provincia, ae f
provisio | provisio, onis f
provisor | provisor, oris m
provisus | provisus, us m
provocatio | provocatio, onis f
provocator | provocator, oris m
provolvo | provolvo, volvi, volutum, ere pass.
proximalis | proximalis, e анат.
proxime | proxime adv.
proximitas | proximitas, atis f
proximo | proximo adv.
proximum | proximum, i n
proximus | proximus, a, um superl.
prudenter | prudenter adv.
prudentia | prudentia, ae f
pruina | pruina, ae поэт.
pruna | pruna, ae f
prunum | prunum, i n
prunus | prunus, i f
prupola | prupola, ae m
prytaneum | prytaneum, i n
prytanis | prytanis, is ( acc.
psalterium | psalterium, i n
psaltria | psaltria, ae f
psephisma | psephisma, atis n
pseudobacca | pseudobacca, ae f
pseudogamia | pseudogamia, ae f
pseudomenos | pseudomenos, i m
pseudopodium | pseudopodium, i n
pseudothyrum | pseudothyrum, i n
psittacus | psittacus, i m
psoa | psoa, as f
psychasthenia | psychasthenia, ae f
Psyche | Psyche, es f
psychiater | psychiater, tri m
psychiatria | psychiatria, ae f
psychologus | psychologus, i m
psychomantium | psychomantium, i n
psychosis | psychosis, is f
psychotherapia | psychotherapia, ae f
pterodactylus | pterodactylus, i m
pterygoma | pterygoma, atis n
pterygomandibularis | pterygomandibularis, e анат.
pterygomaxillaris | pterygomaxillaris, e анат.
pterygopalatinus | pterygopalatinus, a, um анат.
pterygopharyngeus | pterygopharyngeus, a, um анат.
pterygospinalis | pterygospinalis, e анат.
pterygospinosus | pterygospinosus, a, um анат.
pterynon | pterynon, i n
pteryx | pteryx, ygos f
ptisanarium | ptisanarium, i n
ptosis | ptosis, is f
pubertas | pubertas, atis f
pubes | I pubes, eris поэт.
pubicus | pubicus, a, um анат.
publicanus | I publicanus, a, um m
publicatio | publicatio, onis f
publice | publice adv.
publicum | publicum, i n
publicus | publicus, a, um преим.
pubofemoralis | pubofemoralis, e анат.
puboprostaticus | puboprostaticus, a, um анат.
puborectalis | puborectalis, e анат.
pubovesicalis | pubovesicalis, e анат.
Puccinia | Puccinia, ae f
pudendalis | pudendalis, e анат.
pudendum | pudendum, i n
pudendus | pudendus, a, um биолог.
pudenter | pudenter adv.
pudeo | pudeo, ui, itum, ere impers.
pudicitia | pudicitia, ae f
pudor | pudor, oris m
puella | puella, ae f
puer | puer, eri m
pueriliter | pueriliter adv.
pueritia | pueritia, ae f
puerpera | puerpera, ae f
puerperium | puerperium, i n
puerulus | puerulus, i m
pugatim | pugatim adv.
pugil | pugil, ilis m
pugilatus | pugilatus, us m
pugio | pugio, onis m
pugiunculus | pugiunculus, i m
pugna | pugna, ae f
pugnaciter | pugnaciter adv.
pugnator | pugnator, oris m
pugnus | pugnus, i m
pulchre | pulchre (pulcre) adv.
pulchritudo | pulchritudo, inis f
pulcre | pulcre adv.
pulejum | pulejum, i n
pulex | pulex, icis m
pullarius | pullarius, i m
pullum | pullum, i n
pullus | I pullus, a, um m
pulmentarium | pulmentarium, i n
pulmentum | pulmentum, i n
pulmo | pulmo, onis m
pulmonalis | pulmonalis, e анат.
Pulmonaria | Pulmonaria, ae f
pulmonectasia | pulmonectasia, ae f
pulpa | pulpa, ae f
pulpamen | pulpamen, inis n
pulpamentum | pulpamentum, i n
pulpitum | pulpitum, i n
pulposus | pulposus, a, um анат.
puls | puls, pultis f
pulsatio | pulsatio, onis f
pulso | pulso, avi, atum, are поэт.
pulsus | pulsus, us m
pulvillus | pulvillus, i m
pulvinar | pulvinar, aris n
pulvinarium | pulvinarium, i n
pulvinus | pulvinus, i m
pulvis | pulvis, eris m
pumex | pumex, icis m
pumilio | pumilio, onis m
punctim | punctim adv.
punctum | punctum, i n
punitor | punitor (poenitor), oris m
pupilla | I pupilla, ae f
pupillaris | I pupillaris, e анат.
pupillus | pupillus, i m
puppis | puppis, is f
pupula | pupula, ae f
pure | pure adv.
purgamen | purgamen, inis n
purgamentum | purgamentum, i n
purgatio | purgatio, onis f
purgo | purgo, avi, atum, are поэт.
purpura | purpura, ae f
purpuratus | purpuratus, a, um pl.
purpureus | purpureus, a, um поэт.
purulentus | purulentus, a, um мед.
purus | purus, a, um юр.
pus | pus, puris n
pusio | pusio, onis m
pustula | pustula, ae f
puta | puta adv.
putamen | putamen, inis n
putatio | putatio, onis f
puteal | puteal, alis n
putearius | putearius, i m
puteus | puteus, i m
putide | putide adv.
putrefio | putrefio, factus sum, fieri pass.
putus | I putus, a, um m
Pydna | Pydna, ae f
pyelectasia | pyelectasia, ae f
pyelitis | pyelitis, idis f
pyelonephritis | pyelonephritis, idis f
pyelotomia | pyelotomia, ae f
pyga | pyga, ae f
Pygmaei | Pygmaei, orum m
Pygmalion | Pygmalion, onis m
pylae | pylae, arum f
pyloricus | pyloricus, a, um анат.
pylorospasmus | pylorospasmus, i m
pylorostenosis | pylorostenosis, is f
pylorus | pylorus, i m
Pylos | Pylos (-us), i f
pyodermia | pyodermia, ae f
pyogenus | pyogenus, a, um мед.
pyometra | pyometra, ae f
pyosalpinx | pyosalpinx, ingis f
pyothorax | pyothorax, acis m
pyra | pyra, ae f
pyramidalis | pyramidalis, e анат.
pyramis | pyramis, idis f
Pyramus | Pyramus, i m
Pyrenaeus | Pyrenaeus, i m
pyrethron | pyrethron (pyretron, pyrethrum, pyretrum) i n
Pyrra | Pyrra (Pyrrha), ae f
Pyrrho | Pyrrho, onis m
Pyrrhus | Pyrrhus (Pyrrus), i m
Pythagoras | Pythagoras, ae m
Pythagorici | Pythagorici, orum m
Pythia | I Pythia, ae f
Python | Python, onis m
pyuria | pyuria, ae f
pyxis | pyxis, idis f
