abalieno |  abaliēno, āvi, ātum, āre
Abanteus |  Abantēus, a, um
Abantiades |  Abantiădes, ae m
Abapressinum |  Abapressīn(um, i n
Abas |  Abas, antis m
abavus |  abăvus, i m
Abbocortum |  Abbocort(um, i n
Abdera |  Abdēra, ōrum n
Abderites |  Abderītes, ae m
abdicatio |  abdicatio, ōnis f
abdico |  I abdĭco, āvi, ātum, āre
abditus |  abdĭtus, a, um
abdo |  abdo, dĭdi, dĭtum, ĕre
abdomen |  abdōmen, ĭnis n
abdominalis |  abdominālis, e анат.
abducens |  abdūcens, entis анат.
abduco |  abdūco, duxi, ductum, ĕre
abductio |  abductio, ōnis f
abductor |  abductor, ōris m
Abella |  Abella, ae f
Abellani |  Abellāni, ōrum m
abeo |  abeo, ii (īvi), ĭtum, īre
abequito |  abequĭto, āvi, ātum, āre
aberrans |  aberrans, antis анат.
aberratio |  aberratio, ōnis f
aberro |  aberro, āvi, ātum, āre
abfore |  abfŏre inf.
abforem |  abfŏrem impf.
abhinc |  abhinc adv.
abhorreo |  abhorreo, ui, --, ēre
Abicinum |  Abicīn(um, i n
abicio |  abicio
abiegnus |  abiegnus, a, um
abies |  abies, ĕtis f
abigo |  abĭgo, ēgi, actum, ĕre
Abiguanilum |  Abiguanīl(um, i n
abitus |  abĭtus, ūs m
abjectio |  abjectio, ōnis f
abjectus |  abjectus, а, um
abjicio |  abjicio (abicio), jēci, jēctum, ĕre
abjudico |  abjudĭco, āvi, ātum, āre
abjungo |  abjungo, junxi, junctum, ĕre
abjuro |  abjūro, āvi, ātum, āre
ablegatio |  ablegatio, ōnis f
ablego |  ablēgo, āvi, ātum, āre
abludo |  ablūdo, --, --, ĕre досл.
abluo |  abluo, ui, utum ere part.
abnego |  abnego, avi, atum, are
abnormis |  abnormis, e,
abnuo |  abnuo, ui, iturus, ere
abolesco |  abolesco, evi, --, ere
abolitio |  abolitio, onis f
abomino |  abomino, avi, atum, are
abominor |  abominor, atus sum, ari
Abominum |  Abomin(um, i n
abominundus |  abominundus, a, um
aboralis |  aboralis, e анат.
abortio |  abortio, onis f
abortivus |  abortivus, а, um
abrado |  abrado, rasi, rasum, ere
abripio |  abripio, ripui, reptum, ere
Abrodanum |  Abrodan(um, i n
Abrodilum |  Abrodil(um, i n
Abrogenum |  Abrogen(um, i n
abrogo |  abrogo, avi, atum, are
abrotonum |  abrotonum, i n
abrotonus |  abrotonus, i m
Abrovalum |  Abroval(um, i n
abrumpo |  abrumpo, rupi, ruptum, ere
abruptio |  abruptio, onis f
abruptus |  abruptus, a, um
abs |  abs
abscedo |  abscedo, cessi, cessum, ere
abscessio |  abscessio, onis f
abscessus |  abscessus, us m
abscido |  abscido, cidi, cisum, ere
abscindo |  abscindo, scidi, scissum, ere
abscisus |  abscisus, a, um
abscondite |  abscondite adv.
absconditus | absconditus, а, um
abscondo |  abscondo, condi (condidi), conditum, ere
absens |  absens, entis part.
absentia |  absentia, ae f
Absentolum |  Absentol(um, i n
absimilis |  absimilis, e
absinthium |  absinthium, i n
absisto |  absisto, stiti, --, ere
absolute |  absolute adv.
absolutio |  absolutio, onis f
absolvo |  absolvo, solvi, solutum, ere
absonus |  absonus, a, um
absorbeo |  absorbeo, sorbui (sorpsi), sorptum, ere
absp |  absp...
absque |  absque praep.
abstemius |  abstemius, a, um
abstergeo |  abstergeo, tersi, tersum, ere
absterreo |  absterreo, ui, itum, ere
abstinens |  abstinens, entis
abstinenter |  abstinenter adv.
abstinentia |  abstinentia, ae f
abstineo |  abstineo, ui, tentum, ere pass.
Abstinylum |  Abstinyl(um, i n
absto |  absto, --, --, are
abstraho |  abstraho, traxi, tractum, ere
abstrudo |  abstrudo, trusi, trusum, ere
abstrusus |  abstrusus, а, um
absulutus |  absulutus, a, um
absum |  absum, afui (abfui), afuturus, abesse part.
absumo |  absumo, sumpsi, sumptum, ere pass.
absurde |  absurde adv.
absurdus |  absurdus, a, um
Abuleminum |  Abulemin(um, i n
abuleo |  abuleo, evi, itum, ere
abundans |  abundans, antis
abundantia |  abundantia, ae f
abunde |  abunde adv.
abundo |  abundo, avi, atum, are
abusque |  abusque praep.
abusus |  abusus, us m
abutor |  abutor, usus sum, uti
ac |  I ac
acacia |  acacia, ae f
Academia |  Academia, ae f
Academicus |  Academicus, a, um
Academus |  Academus, i m
acalanthis |  acalanthis, idis f
Acamas |  Acamas, antis m
Acanthus |  I Acanthus, i f
Acarnanes |  Acarnanes, um m
Acarnania |  Acarnania, ae f
Acastus |  Acastus, i m
Acca |  Acca Larentia f
accedo |  accedo, cessi, cessum, ere
accelerans |  accelerans, antis
accelero |  accelero, avi, atum, are
accendo |  accendo, cendi, censum, ere pass.
accenseo |  accenseo, --, censum, ere
accensus |  accensus, i m
acceptio |  acceptio, onis f
acceptum |  acceptum, i n
acceptus |  acceptus, a, um
accerso |  accerso
accessio |  accessio, onis f
accessorius |  accessorius, a, um
accessus |  accessus, us m
accido |  I accido, cidi, cisum, ere pass.
accingo |  accingo, cinxi, cinctum, ere pass.
accio |  accio, civi (cii), citum, ire
accipio |  accipio, cepi, ceptum, ere
accipiter |  accipiter, tris m
accitus |  accitus, us m
acclamatio |  acclamatio, onis f
acclamo |  acclamo, avi, atum, are
acclaro |  acclaro, avi, --, are
acclinis |  acclinis, e
acclino |  acclino, avi, atum, are
acclivis |  acclivis, e
acclivitas |  acclivitas, atis f
acclivus |  acclivus, a, um
accola |  accola, ae m
accolo |  accolo, colui, cultum, ere
accommodatio |  accommodatio, onis f
accommodatus |  accommodatus, а, um
accommodo |  accommodo, avi, atum, are
accommodus |  accommodus, a, um
accredo |  accredo, didi, ditum, ere
accresco |  accresco, crevi, cretum, ere
accubita |  accubita, ae f
accubitio |  accubitio, onis f
accubo |  accubo, --, --, are
accumbo |  accumbo, cubui, cubitum, ere
accumulo |  accumulo, avi, atum, are
accurate |  accurate adv.
accuratus |  accuratus, a, um
accuro |  accuro, avi, atum, are
accurro |  accurro, (cu)curri, cursum, ere
accusatio |  accusatio, onis f
accusator |  accusator, aris m
accusatorie |  accusatorie adv.
accusatorius |  accusatorius, a, um
accuso |  accuso, avi, atum, are
Ace |  Ace, es f
Aceclidinum |  Aceclidin(um, i n
Acecolinum |  Acecolin(um, i n
Acedigalum |  Acedigal(um, i n
Acedoxinum |  Acedoxin(um, i n
Acenocumarinum |  Acenocumarin(um, i n
Acenocumarolum |  Acenocumarol(um, i n
Acephenum |  Acephen(um, i n
acer |  I acer, eris n
acer | acer, cris, cre
acerbe |  acerbe adv.
acerbitas |  acerbitas, atis f
acerbo |  acerbo, --, --, are
acerbus |  acerbus, a, um
acernus |  acernus, a, um
acerra |  acerra, ae f
Acerrae |  Acerrae, arum f
Acerrani |  Acerrani, orum m
acervatim |  acervatim adv.
acervo |  acervo, avi, atum, are
acervulus |  acervulus, i m
acervus |  acervus, i m
Acesalum |  Acesal(um, i n
acesco |  acesco, acui, --, ere
Acesines |  Acesines, is m
Acesta |  Acesta, ae f
Acestaei |  Acestaei, orum m
Acestenses |  Acestenses, ium m
Acestes |  Acestes, ae m
acetabularis |  acetabularis, e анат.
acetabulum |  acetabulum, i n
Acetalaxum |  Acetalax(um, i n
Acetaminophenum |  Acetaminophen(um, i n
acetaria |  I acetaria, ae f
acetarium |  acetarium, i n
Acetarsolum |  Acetarsol(um, i n
Acetarsonum |  Acetarson(um, i n
acetas |  acetas, atis m
Acetazinum |  Acetazin(um, i n
Acetazolamidum |  Acetazolamid(um, i n
Aceticylum |  Aceticyl(um, i n
Acetochloroformum |  Acetochloroform(um, i n
Acetolum |  Acetol(um, i n
Acetophenetidinum |  Acetophenetidin(um, i n
Acetophenidinum |  Acetophenidin(um, i n
Acetophenum |  Acetophen(um, i n
Acetoptum |  Acetopt(um, i n
Acetosalum |  Acetosal(um, i n
Acetoxyprogesteronum |  Acetoxyprogesteron(um, i n
Acetparaphenalidum |  Acetparaphenalid(um, i n
Acetphenarsinum |  Acetphenarsin(um, i n
Acetphenolisatinum |  Acetphenolisatin(um, i n
Acetriodonum |  Acetriodon(um, i n
acetum |  acetum, i n
Acetylcholinum |  Acetylcholin(um, i n
Acetyldigitoxinum |  Acetyldigitoxin(um, i n
Acetylinum |  Acetylin(um, i n
acetylsalicylicus |  acetylsalicylicus, a, um фармац.
Acetylsalum |  Acetylsal(um, i n
Acetysalum |  Acetysal(um, i n
Achaei |  Achaei, orum m
Achaemenes |  Achaemenes, is m
Achaemenidae |  Achaemenidae, arum m
Achaemenius |  Achaemenius, a, um
Achaeus |  I Achaeus, a, um m
Achaia |  Achaia f
Achaias |  Achaias, adis f
Achaicus |  Achaicus, a, um
Achais |  Achais, idis f
Achaius |  Achaius, a, um
Acharnae |  Acharnae, arum f
Acharnanus |  Acharnanus, a, um
Achates |  Achates, ae m
acheilia |  acheilia, ae f
Acheloias |  Acheloias, adis f
Acheloides |  Acheloides, um f
Achelois |  Achelois, idis f
Acheloius |  Acheloius, a, um
Achelous |  Achelous, i m
Acheron |  Acheron, ontis ( acc.
Acheruns |  Acheruns, untis m
Acherunsius |  Acherunsius, a, um
Acherusia |  Acherusia, ae f
Acherusis |  Acherusis, idis f
Acherusius |  Acherusius, a, um
Achillea |  Achillea millefolium бот.
Achilleinum |  Achillein(um, i n
Achilleis |  Achilleis, idos f
Achilles |  Achilles, is m
Achilleus |  Achilleus, a, um
Achillides |  Achillides, ae m
Achivi |  Achivi, orum m
achlorhydria |  achlorhydria, ае f
Acholl |  Acholl...
Achradina |  Achradina, ae f
Achroinycinum |  Achroinycin(um, i n
achylia |  achylia, ае f
Acidalia |  Acidalia, ae f
Acidamonum |  Acidamon(um, i n
Acidin |  Acidin-pepsin(um, i n
Acidogenum |  Acidogen(um, i n
Acidol |  Acidol-pepsin(um, i n
acidosis |  acidosis, is f
Acidotestum |  Acidotest(um, i n
Acidulinum |  Acidulin(um, i n
acidum |  acidum, i n
acidus |  acidus, a, um
acies |  acies, ei f
Acilla |  Acilla (Acylla, Acholla), ae f
Acillitani |  Acillitani, orum m
Acillitanus |  Acillitanus
Acilus |  Acilus, a, um
Acimetionum |  Acimetion(um, i n
acinaces |  acinaces, is m
Acinitrazolum |  Acinitrazol(um, i n
acinum |  acinum, i n
acinus |  acinus, i m
acipenser |  acipenser, eris m
Acipepsolum |  Acipepsol(um, i n
Aciphenochinolinum |  Aciphenochinolin(um, i n
Acis |  Acis, idis m
aclys |  aclys, ydis m
Acmonenses |  Acmonenses, ium m
Acmonensis |  Acmonensis, e
Acmonia |  Acmonia, ае f
Acnosanum |  Acnosan(um, i n
Acofinum |  Acofin(um, i n
aconitum |  aconitum i, n
Acophytum |  Acophyt(um, i n
acquiesco |  acquiesco, quievi, quietum, ere
acquiro |  acquiro, quisivi, quisitum, ere
acquisitus |  acquisitus, а, um мед.
Acragan |  Acraga(n)s, antis m
Acrichinum |  Acrichin(um, i n
Acricidum |  Acricid(um, i n
Acriflavinum |  Acriflavin(um, i n
acrimonia |  acrimonia, ae f
Acrinolinum |  Acrinolin(um, i n
Acrinolum |  Acrinol(um, i n
Acrisione |  Acrisione, es f
Acrisioneus |  Acrisioneus, a, um
Acrisioniades |  Acrisioniades, ae m
Acrisius |  Acrisius, i m
acriter |  acriter adv.
acroaesthesia |  acroaesthesia, ае f
acroama |  acroama, atis n
acrocarpus |  acrocarpus, a, um бот.
Acroceraunia |  Acroceraunia, orum n
Acrocorinthus |  Acrocorinthus, i f
acrocyanosis |  acrocyanosis, is f
acrodons |  acrodons, ontis биолог.
acromegalia |  acromegalia, ае f
acromialis |  acromialis, e анат.
acromion |  acromion, i n
acrophobia |  acrophobia, ае f
acropodium |  acropodium, i n
acta |  I acta, ae f
Actaei |  Actaei, orum m
Actaeus |  Actaeus, a, um
Actasum |  Actas(um, i n
Acte |  Acte, es f
Actharum |  Acthar(um, i n
Actiacus |  Actiacus, a, um
Actias |  I Actias, adis
actinomyces |  actinomyces, etis f
Actinomycinum |  Actinomycin(um, i n
actinophagi |  actinophagi, orum n
actio |  actio, onis f
Actium |  Actium, i n
Actius |  Actius, a, um
activatus |  activatus, а, um хим.
Actonum |  Acton(um, i n
actor |  actor, oris m
Actozinum |  Actozin(um, i n
Actropum |  Actrop(um, i n
actuaria |  actuaria, ae f
actuarius |  actuarius, a, um
actus |  actus, us m
actutum |  actutum adv.
aculeus |  aculeus, i m
acumen |  acumen, inis n
acuo |  acuo, acui, acutum, ere
acus |  acus, us f
acusticus |  acusticus, a, um
acute |  acute adv.
acutifolius |  acutifolius, а, um бот.
acutirostris |  acutirostris, e зоолог.
acutus |  acutus, a, um
Acylanidum |  Acylanid(um, i n
Acylanilum |  Acylanil(um, i n
Acylpyrinum |  Acylpyrin(um, i n
Acynormum |  Acynorm(um, i n
ad |  ad praep.
Adabromum |  Adabrom(um, i n
adactio |  adactio, onis f
adaeque |  adaeque adv.
adaequo |  adaequo, avi, atum, are
Adalinum |  Adalin(um, i n
adamanteus |  adamanteus и adamantinus, a, um
adamantinus |  adamantinus, a, um анат.
adamas |  adamas, antis ( acc.
adamo |  adamo, avi, atum, are
Adanonum |  Adanon(um, i n
adaperio |  adaperio, perui, pertum, ire
adapertilis |  adapertilis, e
adaptatio |  adaptatio, onis f
adaquor |  adaquor, atus sum, ari
adaugeo |  adaugeo, auxi, auctum, ere
adbibo |  adbibo, bibi, (bibitum), ere
adc |  adc...
addenseo |  addenseo, --, --, ere
addico |  addico, dixi, dictum, ere
addictio |  addictio, onis f
addictus |  addictus, a, um
addisco |  addisco, didici, --, ere
additamentum |  additamentum, i n
addo |  addo, didi, ditum, ere
addoceo |  addoceo, docui, doctum, ere
addubito |  addubito, avi, atum, are
adduco |  adduco, duxi, ductum, ere
adductio |  adductio, onis f
adductor |  adductor, oris m
adductorius |  adductorius, a, um
Adebitum |  Adebit(um, i n
adedo |  adedo, edi, esum, ere
ademptio |  ademptio, onis f
ademptus |  ademptus, a, um
aden |  aden, is m
adenocarcinoma |  adenocarcinoma, atis n
adenocytus |  adenocytus, i m
adenohypophysis |  adenohypophysis, is f
adenoideus |  adenoideus, a, um анат.
adenoma |  adenoma, atis n
adenosintriphosphoricus |  adenosintriphosphoricus, а, um фармац.
adenotomia |  adenotomia, ае f
adentia |  adentia, ае f
adeo |  I adeo adv.
Adeprilum |  Adepril(um, i n
adeps |  adeps, ipis m
adeptio |  adeptio, onis f
adequito |  adequito, avi, atum, are
Aderminum |  Adermin(um, i n
adf |  adf...
adg |  adg...
adhaereo |  adhaereo, haesi, haesum, ere
adhaeresco |  adhaeresco, haesi, haesum, ere
adhaesivus |  adhaesivus, а, um
adhesio |  adhesio, onis f
adhibeo |  adhibeo, hibui, hibitum, ere
adhinnio |  adhinnio, ivi (ii), itum, ire
adhortatio |  adhortatio, onis f
adhortator |  adhortator, oris m
adhortor |  adhortor, atus sum, ari
adhuc |  adhuc adv.
Adiabene |  Adiabene, es и Adiabena, ae f
Adiabeni |  Adiabeni, orum m
Adiabenicus |  Adiabenicus, a, um
Adiabenus |  Adiabenus, a, um
Adiazinum |  Adiazin(um, i n
adicio |  adicio см.
adigo |  adigo, egi, actum, ere
adimo |  adimo, emi, em(p)tum ere
adinsurgo |  adinsurgo, --, --, ere
Adipalitum |  Adipalit(um, i n
Adipinas |  Adipinas, atis m
Adipiodonum |  Adipiodon(um, i n
adipiscor |  adipiscor, deptus sum, dipisci
adiponecrosis |  adiponecrosis, is f
Adiposidum |  Adiposid(um, i n
Adiposinum |  Adiposin(um, i n
adiposus |  adiposus, a, um
Adiprazina |  Adiprazina, ае f
aditus |  aditus, us m
Adiurecrinum |  Adiurecrin(um, i n
adjaceo |  adjaceo, --, --, ere
adjectio |  adjectio, onis f
adjicio |  adjicio, jeci, jectum, ere
adjudico |  adjudico, avi, atum, are
adjumentum |  adjumentum, i n
adjunctio |  adjunctio, onis f
adjunctum |  adjunctum, i n
adjunctus |  adjunctus, a, um
adjungo |  adjungo, junxi, junctum, ere pass.
adjuro |  adjuro, avi, atum, are
adjutor |  adjutor, oris m
adjutrix |  adjutrix, icis f
adjuvo |  adjuvo, juvi, jutum, juvare
adl |  adl...
admaturo |  admaturo, --, --, are
admetior |  admetior, mensus sum, iri
Admetus |  Admetus, i m
adminiculum |  adminiculum, i n
administer |  administer, tri m
administra |  administra, ae f
administratio |  administratio, onis f
administro |  administro, avi, atum, are
admirabilis |  admirabilis, e
admirandus |  admirandus, a, um
admiratio |  admiratio, onis f
admiror |  admiror, atus sum, ari
admisceo |  admisceo, miscui, mixtum (mistum), ere
admissarius |  admissarius, i m
admissum |  admissum, i n
admissus |  admissus, a, um
admitto |  admitto, misi, missum, ere
admixtio |  admixtio, onis f
admodum |  admodum adv.
admoneo |  admoneo, ui, itum, ere
admonitio |  admonitio, onis f
admonitor |  admonitor, oris m
admonitus |  admonitus, (us) n
admordeo |  admordeo, mordi, morsum, ere
admotus |  admotus, a, um
admoveo |  admoveo, movi, motum, ere
admugio |  admugio, ivi, --, ire
admurmuratio |  admurmuratio, onis f
admurmuro |  admurmuro, avi, atum, are
adn |  I adn...
Adnephrinum |  Adnephrin(um, i n
adnexa |  adnexa, orum n
adoleo |  adoleo, ui, (evi), (ultum), ere
adolesc |  adolesc...
adolesco |  I adolesco, --, --, ere
adolfactorius |  adolfactorius, a, um анат.
Adonalum |  Adonal(um, i n
Adonis |  I Adonis, idis acc.
Adonisidum |  Adonisid(um, i n
adoperio |  adoperio, perui, pertum, ire
Adophenum |  Adophen(um, i n
adoptatio |  adoptatio
adoptio |  adoptio, onis f
adoptivus |  adoptivus, a, um
adopto |  adopto, avi, atum, are
ador |  ador, oris n
adoratio |  adoratio, onis f
adorea |  adorea, ae f
adoreus |  adoreus, a, um
adoria |  adoria, ae f
adorior |  adorior, ortus sum, iri
Adorminum |  Adormin(um, i n
adorno |  adorno, avi, atum, are
adoro |  adoro, avi, atum, are
adp |  adp...
adq |  adq...
adrado |  adrado, rasi, rasum, ere
Adramytt |  Adramyt(t)eum (Adramyt(t)ion), i n
Adramyttenus |  Adramyttenus, i m
Adrana |  Adrana, ae m
Adrastus |  Adrastus, i m
Adrenalinum |  Adrenalin(um, i n
adrenalis |  adrenalis, e анат.
Adrenaminum |  Adrenamin(um, i n
Adreninum |  Adrenin(um, i n
Adrenocorticotrophinum |  Adrenocorticotrophin(um, i n
adrenocorticotropinus |  adrenocorticotropinus, а, um
Adrenoxylum |  Adrenoxyl(um, i n
adrep |  adrep...
Adresonum |  Adreson(um, i n
Adri |  Adri...
Adrianolum |  Adrianol(um, i n
adrid |  adrid..., adrig..., adrip..., adris..., adris..., adrod..., adrog..., adros
Adroxonum |  Adroxon(um, i n
Adrumetini |  Adrumetini, orum m
Adrumetum |  Adrumetum (Hadrumetum), i n
ads |  ads...
adsc |  adsc...
adsp |  adsp...
adst |  adst...
adstringens |  adstringens, entis
adt |  adt...
Aduatuca |  Aduatuca, ae f
Aduatuci |  Aduatuci, orum m
adulatio |  adulatio, onis f
adulescens |  adulescens, entis adj.
adulescentia |  adulescentia, ae f
adulescentulus |  adulescentulus, i m
adulo |  adulo, avi, atum, are
adulor |  adulor, atus sum, ari
adulter |  I adulter, era, erum поэт.
adultera |  adultera, ae f
adulterinus |  adulterinus, a, um
adulterium |  adulterium, i n
adultero |  adultero, avi, atum, are
adultus |  adultus, a, um
adumbilicalis |  adumbilicalis, e анат.
Adumbranum |  Adumbran(um, i n
adumbratus |  adumbratus, a, um
adumbro |  adumbro, avi, atum, are
aduncus |  aduncus, a, um
adurgeo |  adurgeo, --, --, ere
aduro |  aduro, ussi, ustum, ere поэт.
adusque |  adusque praep.
adustus |  adustus, a, um
advecticius |  advecticius, a, um
advehens |  advehens, entis
advelo |  advelo, --, --, are
advena |  advena, ae m
advenio |  advenio, veni, ventum, ire
adventicius |  adventicius, a, um
adventitia |  adventitia, ae f
adventitialis |  adventitialis, e
adventitius |  adventitius, a, um
advento |  advento, avi, atum, are
adventus |  adventus, us m
adversa |  adversa, orum n/pl
adversaria |  adversaria, orum n
adversarius |  I adversarius, a, um m
adversio |  adversio, onis f
adversor |  adversor, atus sum, ari
adversus |  I adversus, a, um adv.
adverto |  adverto, verti, versum, ere
advesperascit |  advesperascit, avit, --, ere impers.
advigilo |  advigilo, avi, atum, are
advocatio |  advocatio, onis f
advocatus |  advocatus, i m
advoco |  advoco, avi, atum, are юр.
advolo |  advolo, avi, atum, are
advolvo |  advolvo, volvi, volutum ere pass.
advor |  advor...
adytum |  adytum, i n
Aeacidejus |  Aeacidejus, a, um
Aeacides |  Aeacides, ae m
aeaculeus |  aeaculeus, a, um
Aeacus |  Aeacus, i m
Aeaee |  Aeaee, es f
Aeaeus |  Aeaeus, a, um
aedes |  aedes (aedis), is f
aedicula |  aedicula, ae f
aedificatio |  aedificatio, onis f
aedificator |  aedificator, oris m
aedificium |  aedificium, i n
aedifico |  aedifico, avi, atum, are
aedilicius |  I aedilicius, i m
aedilis |  aedilis, is m
aedilitas |  aedilitas, atis f
aedis |  aedis, is f
aedituus |  aedituus, i m
Aeeta |  Aeeta m
Aeetaeus |  Aeetaeus, a, um
Aeetias |  Aeetias, adis f
Aegae |  Aegae, arum f
Aegaeus |  Aegaeus, a, um
Aegates |  Aegates, ium f
Aegeates |  Aegeates, ae m
aeger |  aeger, gra, grum
Aegeus |  Aegeus, a, um
Aegeyus |  Aegeyus, ei ( acc.
Aegides |  Aegides, ae m
Aegimurus |  Aegimurus, i f
Aegina |  Aegina, ae f
Aeginenses |  Aeginenses, ium m
Aeginetae |  Aeginetae, arum m
Aeginienses |  Aeginienses, ium m
Aeginium |  Aeginium, i n
Aegion |  Aegion (Aegium), i n
aegis |  aegis, idis f
Aegisthus |  Aegisthus, i m
Aegos |  Aegos Flumen, inis n
aegre |  aegre adv.
aegresco |  aegresco, --, --, ere
aegrimonia |  aegrimonia, ae f
aegritudo |  aegritudo, inis f
aegroto |  aegroto, --, --, are
aegrotus |  aegrotus, a, um
Aegyptius |  I Aegyptius, a, um m
Aegyptus |  Aegyptus, i
Aelianus |  Aelianus, a, um
Aelius |  Aelius, a, um
Aello |  Aello, us f
Aemilianus |  Aemilianus, a, um
Aemilius |  Aemilius, a, um
Aemon |  Aemon...
aemulatio |  aemulatio, onis f
aemulator |  aemulator, oris m
aemulor |  aemulor, atus sum, ari
aemulus |  I aemulus, a, um m
Aenaria |  Aenaria, ae f
Aenea |  Aenea, ae f
Aeneades |  Aeneades, ae m
Aeneas |  Aeneas, ae m
Aeneates |  Aeneates, um m
Aeneis |  Aeneis, idos ( acc.
Aenejus |  Aenejus, a, um
aeneus |  aeneus (aheneus), a, um поэт.
Aenianes |  Aenianes, um m
Aenii |  Aenii, orum m
aenipes |  aenipes, pedis поэт.
aenum |  aenum (ahenum) i n
Aenus |  Aenus (Aenos), i f
aenus |  aenus (ahenus), a, um
Aeoles |  Aeoles, um m
Aeolia |  Aeolia, ae f
Aeolides |  Aeolides, ae m
Aeolis |  I Aeolis, idis f
Aeolius |  Aeolius, a, um
Aeolus |  Aeolus, i m
Aephenalum |  Aephenal(um, i n
Aephycillinum |  Aephycillin(um, i n
aequabilis |  aequabilis, e
aequabilitas |  aequabilitas, atis f
aequabiliter |  aequabiliter adv.
aequaevus |  aequaevus, a, um
aequalis |  I aequalis, e m
aequalitas |  aequalitas, atis f
aequaliter |  aequaliter adv.
aequatio |  aequatio, onis f
aeque |  aeque adv.
aequenoctium |  aequenoctium, i n
Aequi |  Aequi, orum m
Aequiculi |  Aequiculi, orum m
Aequiculus |  Aequiculus, a, um
Aequicus |  Aequicus, a, um
aequilatus |  aequilatus, a, um
aequilongus |  aequilongus, a, um
Aequimaelium |  Aequimaelium (Aequimelium), i n
aequiparo |  aequiparo (aequipero), avi, atum, are
aequitas |  aequitas, atis f
aequo |  aequo, avi, atum, are
aequor |  aequor, oris n
aequoreus |  aequoreus, a, um
aequum |  aequum, i n
aequus |  aequus, a, um compar.
aer |  aer, aeris acc.
aeraria |  aeraria, ae f
aerarium |  aerarium, i n
aerarius |  I aerarius, a, um m
aeratus |  aeratus, a, um поэт.
aereus |  I aereus, a, um
aerifer |  aerifer, era, erum
aeripes |  aeripes, pedis поэт.
aerius |  aerius, a, um
aerobicus |  aerobicus, a, um биолог.
aerobius |  I aerobius, a, um m
aerodromus |  aerodromus, i m
aeronauta |  aeronauta, ae m
Aeronum |  Aeron(um, i n
Aerope |  Aerope, es f
aerophyta |  aerophyta, orum n
aerophyton |  aerophyton, i n
aeroportus |  aeroportus, i m
aerugo |  aerugo, inis f
aerumna |  aerumna, ae f
aerumnosus |  aerumnosus, a, um
aes |  aes, aeris n
Aesacus |  Aesacus, i m
Aesar |  Aesar, aris m
Aesareus |  Aesareus, a, um
Aeschines |  Aeschines, is m
Aeschyleus |  Aeschyleus, a, um
Aeschylus |  Aeschylus, i m
Aesculapius |  Aesculapius, i m
aesculetum |  aesculetum, i n
aesculus |  aesculus, i f
Aescusanum |  Aescusan(um, i n
Aesernia |  Aesernia, ae f
Aesernini |  Aesernini, orum m
Aeserninus |  Aeserninus, a, um
Aesis |  Aesis, is m
Aeson |  Aeson, onis m
Aesonides |  Aesonides, ae m
Aesonius |  Aesonius, a, um
Aesopus |  Aesopus, i m
aestas |  aestas, atis f
aesthesiologia |  aesthesiologia, ae f
aestifer |  aestifer, era, erum
Aestii |  Aestii, orum m
aestimatio |  aestimatio, onis f
aestimator |  aestimator, oris m
aestimo |  aestimo (aestumo), avi, atum, are
aestiva |  aestiva, orum n
aestivus |  aestivus, a, um
aestuarium |  aestuarium, i n
aestuo |  aestuo, avi, atum, are
aestuose |  aestuose adv.
aestuosus |  aestuosus, a, um
aestus |  aestus, us m
Aesula |  Aesula, ae f
aetas |  aetas, atis f
aetaticus |  aetaticus, a, um
aetatula |  aetatula, ae f
aeternitas |  aeternitas, atis f
aeterno |  I aeterno adv.
aeternum |  aeternum adv.
aeternus |  aeternus, a, um
Aethacridinum |  Aethacridin(um, i n
Aethamidum |  Aethamid(um, i n
Aethaminalum |  Aethaminalum-natrium, i n
Aethaperazinum |  Aethaperazin(um, i n
Aethazolum |  I Aethazol(um, i n
aether |  aether, eris ( acc.
aethereus |  aethereus, a, um
aetherius |  aetherius, a, um поэт.
Aethimidinum |  Aethimidin(um, i n
Aethimizolum |  Aethimizol(um, i n
Aethinalum |  Aethinal(um, i n
Aethinyloestradiolum |  Aethinyloestradiol(um, i n
Aethiocarlidum |  Aethiocarlid(um, i n
Aethiops |  Aethiops, opis m
Aethisteronum |  Aethisteron(um, i n
Aethlopia |  Aethlopia, ae f
Aethocainum |  Aethocain(um, i n
Aethonium |  Aethonium, i n
Aethosuximidum |  Aethosuximid(um, i n
Aethoxydum |  Aethoxyd(um, i n
Aethra |  Aethra, ae f
aethra |  aethra, ae f
Aethybarbitalum |  Aethybarbital(um, i n
Aethyladrianolum |  Aethyladrianol(um, i n
Aethylbarbitalum |  Aethylbarbital(um, i n
aethylicus |  aethylicus, а, um хим.
Aethylium |  Aethylium, i n
Aethylmorphinum |  Aethylmorphin(um, i n
Aetmozinum |  Aetmozin(um, i n
Aetna |  Aetna, ae f
Aetnaei |  Aetnaei, orum m
Aetnaeus |  Aetnaeus, a, um
Aetnenses |  Aetnenses, ium m
Aetnensis |  Aetnensis, e
Aetoli |  Aetoli, orum m
Aetolia |  Aetolia, ae f
Aetolicus |  Aetolicus, a, um
Aetolis |  Aetolis, idis f
Aetolius |  Aetolius, a, um
Aetolus |  Aetolus, a, um
aevitas |  aevitas, atis f
Aevitum |  Aevit(um, i n
aevum |  aevum, i n
Afaxinum |  Afaxin(um, i n
Afer |  I Afer, fra, frum m
affabilis |  affabilis, e
affabre |  affabre adv.
affatim |  affatim adv.
affatus |  affatus, us m
affectio |  affectio, onis f
affecto |  affecto, avi, atum, are
affectus |  I affectus, a, um m
afferens |  afferens, entis
affero |  affero, attuli, allatum, afferre
afficio |  afficio, feci, fectum, ere pass.
affigo |  affigo, fixi, fixum, ere
affingo |  affingo, finxi, fictum, ere
affinis |  I affinis, e m
affinitas |  affinitas, atis f
affirmatio |  affirmatio, onis f
affirmo |  affirmo, avi, atum, are
affixus |  affixus, a, um
afflatus |  afflatus, us m
affleo |  affleo, --, --, ere
afflicatio |  afflicatio, onis f
afflicto |  afflicto, avi, atum, are pass.
afflictor |  afflictor, oris m
afflictus |  afflictus, a, um
affligo |  affligo, flixi, flictum, ere
afflo |  afflo, avi, atum, are
affluens |  affluens, entis
affluenter |  affluenter adv.
affluentia |  affluentia, ae f
affluo |  affluo, fluxi, fluxum, ere
affor |  affor, fatus sum, fari поэт.
affore |  affore inf.
afforem |  afforem impf.
affui |  affui pf.
affulgeo |  affulgeo, fulsi, --, ere
affundo |  affundo, fudi, fusum, ere pass.
affuturus |  affuturus, a, um part.
afore |  afore inf.
aforem |  aforem impf.
Afranianus |  Afranianus, a, um
Afranius |  Afranius, a, um
Africa |  Africa, ae f
Africanae |  Africanae, arum f
Africanus |  Africanus, a, um
Africus |  I Africus, a, um m
Afungilum |  Afungil(um, i n
Agamedes |  Agamedes, is m
Agamemnon |  Agamemno(n), onis m
Agamemnonius |  Agamemnonius, a, um
Aganippe |  Aganippe, es f
Aganippeus |  Aganippeus, a, um
Aganippis |  Aganippis, idos f
agaso |  agaso, onis m
Agathocles |  Agathocles, es m
Agathyrsi |  Agathyrsi, orum m
Agave |  Agave, es f
age |  age, agedum
Agedincum |  Agedincum, i n
Agelastus |  Agelastus, i m
agellulus |  agellulus, i m
agellus |  agellus, i m
agema |  agema, atis n
Agenor |  Agenor, oris m
Agenoreus |  Agenoreus, a, um
Agenorides |  Agenorides, ae m
ager |  ager, gri m
Agesilaus |  Agesilaus, i m
agesis |  agesis
agger |  agger, eris m
aggero |  I aggero, avi, atum, are поэт.
agglomero |  agglomero, avi, atum, are поэт.
aggravo |  aggravo, avi, atum, are
aggredior |  aggredior, gressus sum, gredi
aggregatus |  aggregatus, a, um
aggrego |  aggrego, avi, atum, are
agilis |  agilis, e
agilitas |  agilitas, atis f
Agis |  Agis, idis ( acc.
agitabilis |  agitabilis, e
agitatio |  agitatio, onis f
agitator |  agitator, oris m
agitedum |  agitedum pl.
agito |  agito, avi, atum, are поэт.
Aglaie |  Aglaie, es f
Aglaophon |  Aglaophon, ontis m
Aglauros |  Aglauros, i f
Agliralum |  Agliral(um, i n
aglossia |  aglossia, ae f
Aglycidum |  Aglycid(um, i n
agmen |  agmen, inis n
agna |  agna, ae f
agnascor |  agnascor, natus sum, nasci
agnina |  agnina, ae f
agninus |  agninus, a, um
agnosco |  agnosco, novi, nitum, ere
agnus |  agnus, i m
ago |  ago, egi, actum, ere pass.
Agolutinum |  Agolutin(um, i n
Agonalia |  Agonalia, orum n
Agonalis |  Agonalis, e
Agonia |  Agonia, orum n
Agonius |  I Agonius, a, um m
Agontanum |  Agontan(um, i n
agrarii |  agrarii, orum m
agrarius |  agrarius, a, um
agrestis |  I agrestis, e gen.
agricola |  I agricola, ae m
agricultor |  agricultor, oris m
Agrigentini |  Agrigentini, orum m
Agrigentinus |  Agrigentinus, a, um
Agrigentum |  Agrigentum, i n
Agrippa |  Agrippa, ae m
Agrippina |  Agrippina, ae f
Agrippinenses |  Agrippinenses, ium m
Agrippinensis |  Agrippinensis, e
agronomus |  agronomus, i m
Agyieyus |  Agyieyus, ei m
Agylla |  Agylla, ae f
Agylleyus |  Agylleyus, ei m
Agyllini |  Agyllini, orum m
Agyllinus |  Agyllinus, a, um
Agyrinenses |  Agyrinenses, ium m
Agyrinensis |  Agyrinensis, e
Agyrium |  Agyrium, i n
ah |  ah! aha! (a!)
Ahala |  Ahala, ae m
Aharna |  Aharna, ае f
ahen |  ahen...
ai |  ai!
Ailanthus |  Ailanthus, i f
aio |  aio, ait, --, -- verb.
Aius |  Aius Loquens
Ajax |  Ajax, acis m
Ajmalinum |  Ajmalin(um, i n
Akinetonum |  Akineton(um, i n
Akinophylum |  Akinophyl(um, i n
Aklimanum |  Akliman(um, i n
Akrolutinum |  Akrolutin(um, i n
Aktedrinum |  Aktedrin(um, i n
ala |  ala, ae f
Alabanda |  Alabanda, orum n
Alabandenses |  Alabandenses, ium m
Alabandensis |  Alabandensis, e
Alabandeyus |  Alabandeyus, eos m
Alabandus |  Alabandus, i m
alacer |  alacer, cris, cre (редко alacris, e),
alacrimo |  alacrimo, --, --, are
alacritas |  alacritas, atis f
Alamanni |  Alamanni, orum m
Alamidonum |  Alamidon(um, i n
alares |  alares, ium m
alarii |  alarii, orum m
alaris |  alaris, e анат.
alarius |  alarius, a, um
Alasca |  Alasca, ae f
alatus |  alatus, a, um анат.
alauda |  alauda, ae f
Alba |  Alba, ae f
Albani |  Albani, orum m
Albania |  Albania, ae f
Albanum |  Albanum, i n
Albanus |  Albanus, a, um
Albarussia |  Albarussia, ae f
albatus |  albatus, a, um
Albenses |  Albenses, ium m
Albensis |  Albensis, e
albeo |  albeo, --, --, ere
albesco |  albesco, --, --, ere
Albianus |  Albianus, a, um
albicans |  albicans, antis
albiceps |  albiceps, cipitis зоолог.
Albichtholum |  Albichthol(um, i n
Albici |  Albici, orum m
albico |  albico, --, --, are
albicollis |  albicollis, e зоолог.
albidus |  albidus, a, um
albifrons |  albifrons, ontis зоолог.
Albis |  Albis, is m
Albius |  Albius, a, um
Albomycinum |  Albomycin(um, i n
Albromanum |  Albroman(um, i n
Albucid |  Albucid-natrium
albugineus |  albugineus, a, um анат.
Albula |  Albula, ae f
album |  album, i n
albuminatus |  albuminatus, а, um мед.
Albunea |  Albunea, ae f
Alburnus |  Alburnus, i m
albus |  albus, a, um
Alcaeus |  Alcaeus, i m
Alcamenes |  Alcamenes, is m
Alcathoe |  Alcathoe, es f
Alcathous |  Alcathous, i m
Alce |  Alce, es f
Alcedinidae |  Alcedinidae, arum f
alces |  alces, is f
Alcestis |  Alcestis, idis acc.
Alceus |  Alceus (= Alce^us), ei m
Alcibiades |  Alcibiades, is acc.
Alcides |  Alcides, ae m
Alcimede |  Alcimede, es f
Alcinous |  Alcinous, i m
Alcmaeon |  Alcmaeo(n), onis m
Alcmaeonius |  Alcmaeonius, a, um
Alcmena |  Alcmena, ae f
alcohol |  alcohol, olis n
alcoholicus |  I alcoholicus, a, um m
Alcoparum |  Alcopar(um, i n
Alcophobinum |  Alcophobin(um, i n
alcyon |  alcyon, onis f
Alcyone |  Alcyone, es f
Aldactonum |  Aldacton(um, i n
Alderlinum |  Alderlin(um, i n
Aldevitum |  Aldevit(um, i n
Aldinamidum |  Aldinamid(um, i n
Aldomethylum |  Aldomethyl(um, i n
Aldometum |  Aldomet(um, i n
Aldominum |  Aldomin(um, i n
Aldosteronum |  Aldosteron(um, i n
alea |  alea, ae f
aleator |  aleator, oris m
aleatorius |  aleatorius, a, um
alec |  alec, (h)allec n
Alecto |  Alecto, us f
Aleii |  Aleii campi m
Alemanni |  Alemanni, orum m
Alemon |  Alemon, onis m
Alemonides |  Alemonides, ae m
Alentinum |  Alentin(um, i n
Alentolum |  Alentol(um, i n
Alepsinum |  Alepsin(um, i n
Alertolum |  Alertol(um, i n
ales |  I ales, itis m
Alesia |  Alesia, ae f
Aletrinas |  Aletrinas, atis
Aletrinates |  Aletrinates, ium m
Aletrium |  Aletrium, i n
Aleudrinum |  Aleudrin(um, i n
Alevas |  Alevas, ae m
alex |  alex, ecis n
Alexander |  Alexander, dri m
Alexandrea |  Alexandrea (-ia), ae f
Alexandreus |  Alexandreus, a, um
Alexandrini |  Alexandrini, orum m
Alexandrinus |  Alexandrinus, a, um
Alfenus |  Alfenus, i m
Alficetinum |  Alficetin(um, i n
Alfimidum |  Alfimid(um, i n
alga |  alga, ae f
Algamonum |  Algamon(um, i n
algeo |  algeo, alsi, --, ere
Algidonum |  Algidon(um, i n
Algidum |  Algidum, i n
Algidus |  I Algidus, i m
Algilum |  Algil(um, i n
Algocalminum |  Algocalmin(um, i n
Algolysinum |  Algolysin(um, i n
Algopyrinum |  Algopyrin(um, i n
algor |  algor, oris m
alia |  alia adv.
alias |  alias adv.
alibi |  alibi adv.
alicubi |  alicubi adv.
alicunde |  alicunde adv.
Alidasum |  Alidas(um, i n
alienatio |  alienatio, onis f
alienigena |  alienigena, ae m
alieno |  alieno, avi, atum, are pass.
alienum |  alienum, i n
alienus |  I alienus, a, um m
Alifae |  Alifae, Alifanus
aliger |  aliger, era, erum
alimentarius |  alimentarius, a, um
alimentum |  alimentum, i n
Alindorum |  Alindor(um, i n
alio |  alio adv.
alioqui |  alioqui adv.
alipes |  alipes, edis поэт.
Aliphera |  Aliphera, ae f
aliqua |  aliqua adv.
aliquamdiu |  aliquamdiu adv.
aliquandiu |  aliquandiu
aliquando |  aliquando adv.
aliquanto |  aliquanto adv.
aliquantum |  I aliquantum adv.
aliquantus |  aliquantus, a, um
aliqui |  aliqui, aliquae, aliquod
aliquid |  aliquid adv.
aliquis |  aliquis, aliqua, aliquid pl.
aliquo |  aliquo adv.
aliquot |  aliquot indecl.
aliquoties |  aliquoties adv.
Alison |  Aliso(n), onis m
alisphenoidus |  alisphenoidus, i m
aliter |  aliter adv.
Alitinalum |  Alitinal(um, i n
alium |  alium, i n
aliunde |  aliunde adv.
alius |  alius, a, ud gen.
Alkironum |  Alkiron(um, i n
allabor |  allabor, lapsus sum, labi
allaboro |  allaboro, --, --, are
Allacilum |  Allacil(um, i n
allantois |  allantois, idis f
allapsus |  allapsus, us m
allatro |  allatro, avi, atum, are
allecto |  allecto, avi, atum, are
Alledrylum |  Alledryl(um, i n
allegatio |  allegatio, onis f
allego |  I allego, avi, atum, are
Allerganum |  Allergan(um, i n
allergia |  allergia, ае f
allergicus |  allergicus, а, um мед.
Allergivalum |  Allergival(um, i n
allevamentum |  allevamentum, i n
allevo |  allevo, avi, atum, are pass.
Allia |  Allia, ae f
allicio |  allicio, lexi, lectum, ere
allido |  allido, lisi, lisum, ere pass.
Alliensis |  Alliensis, e
Allifae |  Allifae, arum f
Allifana |  Allifana, orum n
Allifanus |  Allifanus, a, um
alligo |  alligo, avi, atum, are
Allilcepum |  Allilcep(um, i n
Allilglycerum |  Allilglycer(um, i n
Allilsatum |  Allilsat(um, i n
allino |  allino, levi, litum, ere
Alliphae |  Alliphae, arum f
allium |  I allium, i n
Allobroges |  Allobroges, um m
Allobrogicus |  Allobrogicus, a, um
Allocainum |  Allocain(um, i n
Allocholum |  Allochol(um, i n
allochoria |  allochoria, ae f
allocutio |  allocutio, onis f
alloquium |  alloquium, i n
alloquor |  alloquor, locutus (loquutus) sum, loqui
allotransplantatio |  allotransplantatio, onis f
allucin |  allucin...
alludo |  alludo, lusi, lusum, ere
alluo |  alluo, lui, --, ere
Alluvalum |  Alluval(um, i n
alluvies |  alluvies, ei f
Alma |  Alma, ae f
Almagelum |  Almagel(um, i n
Almana |  Almana, ae f
Almo |  Almo, onis m
almus |  almus, a, um
alnus |  alnus, i f
alo |  alo, alui, alitum (altum), ere
Aloeyus |  Aloeyus, ei m
Aloidae |  Aloidae, arum m
Alope |  Alope, es f
Alpes |  Alpes, ium f
Alpheias |  Alpheias, adis f
Alpheus |  I Alpheus (-os), i m
Alpicus |  Alpicus, i m
Alpinus |  Alpinus, a, um
alquam |  alquam-multus, a, um
Alsiense |  Alsiense, is n
Alsium |  Alsium, i n
Alslensis |  Alslensis, e
altaria |  altaria, ium n
alte |  alte adv.
alter |  alter, era, erum gen.
altercatio |  altercatio, onis f
altercor |  altercor, atus sum, ari поэт.
alternis |  alternis adv.
alterno |  alterno, avi, atum, are
alternus |  alternus, a, um
alteruter |  alteruter, alterutra gen.
Althaea |  Althaea, ae f
altilia |  altilia, ium n
altilis |  altilis, e
Altinates |  Altinates, um m
Altinum |  Altinum, i n
altisonus |  altisonus, a, um поэт.
altitonans |  altitonans, antis поэт.
altitudo |  altitudo, inis f
altor |  altor, oris m
altrix |  altrix, icis f
altum |  altum, i n
altus |  altus, a, um
alumna |  alumna, ae f
alumnus |  I alumnus, a, um m
Aluntini |  Aluntini, orum m
Aluntinus |  Aluntinus, a, um
Aluntium |  Aluntium, i n
aluta |  aluta, ae f
alvarium |  alvarium, i n
alveare |  alveare, is n
alvearium |  alvearium, i n
alveolaris |  alveolaris, e анат.
alveolus |  alveolus, i m
alveus |  alveus, i m
alvus |  alvus, i f
Alyattes |  Alyattes, is m
Alymon |  Alymon, onis m
Alyzia |  Alyzia, ae f
amabilis |  amabilis, e
amabiliter |  amabiliter adv.
Amalthea |  I Amalthea, ae f
Amaltheum |  Amaltheum, i
amandatio |  amandatio, onis f
amando |  amando, avi, atum, are
Amanicae |  Amanicae Pylae
Amanienses |  Amanienses, ium m
amans |  amans, antis adj.
amanter |  amanter adv.
Amantia |  Amantia, ae f
Amantiani |  Amantiani, orum m
Amanus |  Amanus, i m
amara |  amara, orum n
amaracus |  amaracus, i m
amarantus |  amarantus, i m
amaror |  amaror, oris m
amarus |  amarus, a, um
Amarynthis |  Amarynthis, idis f
Amasenus |  Amasenus, i m
Amastriacus |  Amastriacus, a, um
Amastriani |  Amastriani, orum m
Amastris |  Amastris, idis f
Amathus |  Amathus, untis acc.
Amathusia |  Amathusia, ае f
Amathusiacus |  Amathusiacus, a, um
amator |  amator, oris m
amatorie |  amatorie adv.
Amazon |  Amazon, onis acc.
Amazonic |  Amazoni(c)us, a, um
Amazonis |  Amazonis, idis f
ambactus |  ambactus, i m
ambages |  ambages, um f
Ambarri |  Ambarri, orum m
ambedo |  ambedo, edi, esum, ere
Ambiani |  Ambiani, orum m
Ambibarii |  Ambibarii, orum m
ambiens |  ambiens, entis анат.
ambigo |  ambigo, --, --, ere
ambigue |  ambigue adv.
ambiguitas |  ambiguitas, atis f
ambiguum |  ambiguum, i n
ambiguus |  ambiguus, a, um
Ambiliati |  Ambiliati, orum m
ambio |  ambio, ivi (ii), itum, ire
Ambiorix |  Ambiorix, igis m
ambitio |  ambitio, onis f
ambitiose |  ambitiose adv.
ambitiosus |  ambitiosus, a, um
ambitus |  ambitus, us m
Ambivareti |  Ambivareti, orum m
Ambivariti |  Ambivariti, orum m
ambo |  ambo, ae, o
Ambracia |  Ambracia, ae f
Ambracias |  Ambracias, adis
Ambracienses |  Ambracienses, ium m
Ambraciensis |  Ambraciensis, e
Ambraciotes |  Ambraciotes, ae m
Ambracius |  Ambracius, a, um
Ambrones |  Ambrones, um m
ambrosia |  ambrosia, ae f
ambrosius |  ambrosius, a, um
Ambrysus |  Ambrysus, i f
ambubaja |  ambubaja, ae f
ambulacrum |  ambulacrum, i n
ambulatio |  ambulatio, onis f
ambulo |  ambulo, avi, atum, are
amburo |  amburo, ussi, ustum, ere pass.
amellus |  amellus, i m
Amenanus |  I Amenanus, a, um m
amenorrhoea |  amenorrhoea, ае f
amens |  amens, entis
amentia |  amentia, ae f
amentum |  amentum (ammentum), i n
Ameria |  Ameria, ae f
America |  America, ae f
Amerinus |  Amerinus, a, um
Ameriola |  Ameriola, ae f
ames |  ames, itis m
Amestratini |  Amestratini, orum m
Amestratinus |  Amestratinus, a, um
Amestratus |  Amestratus, i f
amethystus |  amethystus, i f
amica |  amica, ae f
amice |  amice adv.
amicio |  amicio, micui (mixi), mictum, ire pass.
amicitia |  amicitia, ae f
amictus |  amictus, us m
amiculum |  amiculum, i n
amiculus |  amiculus, i m
amicus |  I amicus, a, um m
amigro |  amigro, -- , --, are
Amilcar |  Amilcar
Aminaea |  Aminaea, ae f
Aminaeus |  Aminaeus
Amisia |  Amisia, ae f
amissio |  amissio, onis f
amissus |  amissus, us m
Amisus |  Amisus, i f
amita |  amita, ae f
Amiternini |  Amiternini, orum m
Amiterninus |  Amiterninus, a, um
Amiternum |  Amiternum, i n
Amiternus |  Amiternus, a, um
amitto |  amitto, misi, missum, ere
ammentum |  ammentum, i n
Ammon |  Ammon (Hammon), onis m
Ammoniacus |  Ammoniacus, a, um
amnesia |  amnesia, ае f
amnicola |  amnicola, ae f
amniculus |  amniculus, i m
amnion |  amnion, i n
amnis |  amnis, is m
amo |  amo, avi, atum, are
amoebiasis |  amoebiasis, is f
amoenitas |  amoenitas, atis f
amoenus |  amoenus, a, um
amolior |  amolior, molitus sum, iri
amomum |  amomum (amomon), i n
amor |  amor, oris m
Amorgos |  Amorgos (-us), i f
amoveo |  amoveo, movi, motum, ere
amperium |  amperium, i n
Amphiaraeus |  Amphiaraeus, a, um
Amphiaraides |  Amphiaraides, ae m
Amphiaraus |  Amphiaraus, i m
amphiarthrosis |  amphiarthrosis, is f
amphibius |  amphibius, a, um зоолог.
Amphictyones |  Amphictyones, um acc.
Amphilochi |  Amphilochi, orum m
Amphilochia |  Amphilochia, ae f
Amphilochicum |  Amphilochicum, i n
Amphilochus |  Amphilochus, i m
Amphion |  Amphio(n), onis m
Amphionius |  Amphionius, a, um
Amphipoda |  Amphipoda, orum n
Amphipolis |  Amphipolis, is ( acc.
Amphipolitanus |  Amphipolitanus, a, um
Amphissa |  Amphissa, ae f
Amphitrite |  Amphitrite, es f
Amphitryon |  Amphitryo(n) ( арх.
Amphitryoniades |  Amphitryoniades, ae m
amphora |  amphora, ae f
Amphrysius |  Amphrysius, a, um
Amphrysus |  Amphrysus (-os), i m
ample |  ample adv.
amplector |  amplector, plexus sum, plecti
amplexor |  amplexor, atus sum, ari
amplexus |  amplexus, us m
amplificatio |  amplificatio, onis f
amplifico |  amplifico, avi, atum, are
amplio |  amplio, avi, atum, are юр.
amplitudo |  amplitudo, inis f
amplius |  amplius compar.
amplus |  amplus, a, um
Ampsanctus |  Ampsanctus, i m
Ampsivarii |  Ampsivarii, orum m
ampulla |  ampulla, ae f
ampullaris |  ampullaris, e анат.
ampullor |  ampullor, --, --, ari поэт.
amputatio |  I amputatio, onis f
amputo |  amputo, avi, atum, are
Ampycides |  Ampycides, ae m
Ampycus |  Ampycus, i m
amurca |  amurca, ae f
Amyclae |  Amyclae, arum f
Amyclaeus |  Amyclaeus, a, um поэт.
Amyclanus |  Amyclanus, a, um
Amyclides |  Amyclides, ae m
Amycus |  Amycus, i m
amygdala |  amygdala, ae f
amygdalinus |  amygdalinus, a, um
amygdalum |  amygdalum, i n
amylum |  amylum, i n
Amymone |  Amymone, es f
Amyntas |  Amyntas, ae m
Amyntiades |  Amyntiades, ae m
Amyntor |  Amyntor, oris m
Amyntorides |  Amyntorides, ae m
amystis |  amystis, is f
Amythaon |  Amythaon, onis m
Amythaonius |  Amythaonius, a, um
an |  an conj.
anabathrum |  anabathrum, i n
Anaces |  Anaces, um m
Anacharsis |  Anacharsis, idis m
Anacreon |  Anacreon, ontis ( acc.
anaerobicus |  anaerobicus, a, um биолог.
anaerobius |  anaerobius, a, um
Anagnia |  Anagnia, ae f
Anagnini |  Anagnini, orum m
Anagninum |  Anagninum, i n
Anagninus |  Anagninus, a, um
anagnostes |  anagnostes, ae m
Anaiodinum |  Anaiodin(um, i n
analectris |  analectris, idis f
analepticum |  analeptic(um, i n
analepticus |  analepticus, а, um мед.
analeptris |  analeptris, idis f
Analgetinum |  Analgetin(um, i n
Analginum |  Analgin(um, i n
analis |  analis, e анат.
Analphenum |  Analphen(um, i n
Analuxum |  Analux(um, i n
analysis |  analysis, is f
ananasa |  ananasa, ae f
anapaestus |  anapaestus, a, um
Anaphe |  Anaphe, es f
Anaprilinum |  Anaprilin(um, i n
Anapus |  Anapus, i m
Anapyrinum |  Anapyrin(um, i n
Anarconum |  Anarcon(um, i n
Anartes |  Anartes, ium m
anas |  I anas, atis f
anastomosis |  anastomosis, is f
anastomoticus |  anastomoticus, a, um анат.
Anatensolum |  Anatensol(um, i n
anatomia |  anatomia, ae f
anatomicus |  anatomicus, a, um мед.
anatomus |  anatomus, i m
Anatruxonium |  Anatruxonium, i n
Anavitum |  Anavit(um, i n
Anaxagoras |  Anaxagoras, ae m
Anaxarchus |  Anaxarchus, i m
Anaximander |  Anaximander, dri m
Anaximenes |  Anaximenes, is m
Anbitalum |  Anbital(um, i n
anceps |  anceps, cipitis abl.
Anchialos |  Anchialos, i f
Anchises |  Anchises, ae m
Anchiseus |  Anchiseus, a, um
Anchisiades |  Anchisiades, ae m
ancile |  ancile, is gen.
ancilla |  ancilla, ae f
ancillula |  ancillula, ae f
ancon |  ancon, onis m
anconeus |  anconeus, a, um
Ancophenum |  Ancophen(um, i n
ancora |  ancora, ae f
ancorarius |  ancorarius, a, um
Ancortonum |  Ancorton(um, i n
ancurale |  ancurale, is n
Ancyra |  Ancyra, ae f
Andania |  Andania, ae f
Andaxinum |  Andaxin(um, i n
Andecalinum |  Andecalin(um, i n
Andecavi |  Andecavi, orum m
Andes |  Andes, ium m
andiens |  andiens, entis m
Andipalum |  Andipal(um, i n
Andocides |  Andocides, is m
Andriscus |  Andriscus, i m
cardialis |  cardialis, e
Cardiamidum |  Cardiamid(um, i n
Cardianus |  Cardianus, a, um
Cardiazolum |  Cardiazol(um, i n
Cardiginum |  Cardigin(um, i n
Cardiofluxum |  Cardioflux(um, i n
Cardiografinum |  Cardiografin(um, i n
cardiographia |  cardiographia, ae f
cardiologia |  cardiologia, ae f
cardiologus |  cardiologus, i m
cardiolysis |  cardiolysis, is f
cardiomegalia |  cardiomegalia, ae f
cardiomyopathia |  cardiomyopathia, ae f
cardiopathia |  cardiopathia, ae f
cardiopulmonalis |  cardiopulmonalis, e мед.
cardiorrhexis |  cardiorrhexis, is f
Cardiorythminum |  Cardiorythmin(um, i n
cardiosclerosis |  cardiosclerosis, is f
cardiostenosis |  cardiostenosis, is f
Cardiotoxinum |  Cardiotoxin(um, i n
Cardiotrastum |  Cardiotrast(um, i n
Cardiovalenum |  Cardiovalen(um, i n
cardiovascularis |  cardiovascularis, e анат.
cardo |  cardo, inis m
carduus |  carduus, i m
care |  care adv.
carectum |  carectum, i n
careo |  careo, ui, (iturus), ere
Cares |  Cares, um m
carex |  carex, icis f
Caria |  Caria, ae f
Carica |  Carica, ae f
Caricus |  Caricus, a, um
caries |  caries, ei f
carina |  carina, ae f
cariosns |  cariosns, a, um
caris |  caris, idis f
caristia |  caristia, orum n
caritas |  caritas, atis f
Carmelus |  Carmelus, i m
carmen |  carmen, inis n
Carmenta |  Carmenta, ae f
Carmentalia |  Carmentalia, ium n
Carmentalis |  Carmentalis, e
Carmentis |  Carmentis, is f
carminativus |  carminativus, a, um фармац.
Carmo |  Carmo, onis f
Carmonenses |  Carmonenses, ium m
carnalis |  carnalis, e
carnasus |  carnasus, a, um
Carneades |  Carneades, is m
Carneadeus |  Carneadeus, a, um
Carneadius |  Carneadius, a, um
carneus |  carneus, a, um
Carni |  Carni, orum m
carnifex |  carnifex (carnufex), icis m
carnificina |  carnificina (carnuficina), ae f
carnifico |  carnifico, avi, atum, are
carnis |  carnis, is f
Carnivora |  Carnivora, orum n
carnivorus |  carnivorus, a, um зоолог.
carnosus |  carnosus, a, um
carnufex |  carnufex, icis m
carnuficina |  carnuficina, ae f
Carnuntum |  Carnuntum, i n
Carnutes |  Carnutes, um m
caro |  caro, carnis f
caroticotympanicus |  caroticotympanicus, a, um анат.
caroticus |  caroticus, a, um анат.
carotidobasilaris |  carotidobasilaris, e анат.
Carotinum |  Carotinum, i n
carotis |  carotis, idis анат.
Carotolinum |  Carotolin(um, i n
carpalis |  carpalis, e анат.
Carpathius |  Carpathius, a, um
Carpathus |  Carpathus (-os), i f
carpentum |  carpentum, i n
Carpetani |  Carpetani, orum m
Carpetania |  Carpetania, ae f
carpeus |  carpeus, a, um анат.
Carpi |  Carpi, orum m
carpio |  carpio, onis m
carpo |  carpo, carpsi, carptum, ere
carpologia |  carpologia, ae f
carpometacarpeus |  carpometacarpeus, a, um анат.
carpophorum |  carpophorum, i n
carptim |  carptim adv.
carpus |  carpus, i m
Carrae |  Carrae, arum f
Carruca |  Carruca, ae f
carrus |  carrus, i m
Carseolanus |  Carseolanus, a, um
Carseoli |  Carseoli, orum m
triclinium |  triclinium, i n
Tricocetum |  Tricocet(um, i n
Tricofurinum |  Tricofurin(um, i n
tricolor |  tricolor, oris
Tricomum |  Tricom(um, i n
tricorpor |  tricorpor, oris
Tricresolum |  Tricresol(um, i n
Trictalum |  Trictal(um, i n
tricuspidalis |  tricuspidalis, e анат.
tricuspis |  tricuspis, idis
tridactylus |  tridactylus, a, um биолог.
tridens |  I tridens, entis m
tridentifer |  tridentifer, eri m
tridentiger |  tridentiger, eri m
Tridionum |  Tridion(um, i n
triduum |  triduum, i n
triennia |  triennia, ium n
triennium |  triennium, i n
triens |  triens, entis m
trientabulum |  trientabulum, i n
trierarchus |  trierarchus, i m
trieris |  I trieris, e f
trietericus |  trietericus, a, um
trieteris |  trieteris, itis f
trifariam |  trifariam adv.
trifaux |  trifaux, aucis
trifidus |  trifidus, a, um
Triflocidum |  Triflocid(um, i n
Trifluoroperazinum |  Trifluoroperazin(um, i n
Trifluperazinum |  Trifluperazin(um, i n
Trifluperidolum |  Trifluperidol(um, i n
Trifolium |  Trifolium, i n
triformis |  triformis, e
Trifosfodinum |  Trifosfodin(um, i n
Trifosylum |  Trifosyl(um, i n
Triftazinum |  Triftazin(um, i n
Trifuroxum |  Trifurox(um, i n
trigeminofacialis |  trigeminofacialis, e анат.
trigeminus |  trigeminus (поэт. tergeminus), a, um
trigesimus |  trigesimus, a, um
triginta |  triginta
trigon |  trigon, onis
trigonum |  trigonum, i n
trigonus |  trigonus, a, um анат.
trigynus |  trigynus, a, um биолог.
Triiotrastum |  Triiotrast(um, i n
Trilafonum |  Trilafon(um, i n
Trilaxum |  Trilax(um, i n
Trilenum |  Trilen(um, i n
trilibris |  trilibris, e
trilinguis |  trilinguis, e
trilix |  trilix, icis
Trimanylum |  Trimanyl(um, i n
Trimarum |  Trimar(um, i n
Trimecainum |  Trimecain(um, i n
Trimedoximum |  Trimedoxim(um, i n
Trimeperidinum |  Trimeperidin(um, i n
Trimethadionum |  Trimethadion(um, i n
Trimethinum |  Trimethin(um, i n
trimetrus |  trimetrus, i m
Trimitanum |  Trimitan(um, i n
trimus |  trimus, a, um
Trinacria |  Trinacria, ae f
Trinexum |  Trinex(um, i n
trini |  trini, ae, a pl.
Trinitrinum |  Trinitrin(um, i n
Trinitroglycerolum |  Trinitroglycerol(um, i n
Trinitrolum |  Trinitrol(um, i n
trinodis |  trinodis, e
trinus |  trinus, a, um pl.
trio |  trio, onis m
Triombrinum |  Triombrin(um, i n
Trioninum |  Trionin(um, i n
Triopacum |  Triopac(um, i n
Trioxazinum |  Trioxazin(um, i n
tripartito |  tripartito (tripertito) adv.
tripartitus |  tripartitus (tripertitus), a, um
tripedalis |  tripedalis, e
Triperidolum |  Triperidol(um, i n
tripertit |  tripertit...
tripes |  tripes, edis
Triphosadenum |  Triphosaden(um, i n
Triphosphodinum |  Triphosphodin(um, i n
triplex |  I triplex, icis поэт.
Triptizolum |  Triptizol(um, i n
Triptylum |  Triptyl(um, i n
tripudio |  tripudio, --, --, are
tripudium |  tripudium, i n
tripus |  tripus, odis m
triquetrus |  triquetrus, a, um анат.
triremis |  triremis, is f
Tyrtaeus |  Tyrtaeus, i m
Tzalolum |  Tzalol(um, i n
U |  U, u ист.
U. |  U. сокр. от
U.I. |  U.I. сокр. от
U.I.D. |  U.I.D. сокр. от
U.R. |  U.R. сокр. от
U.S. |  U.S. сокр. от
uber |  I uber, eris n
uberius |  uberius ( superl.
ubertas |  ubertas, atis f
ubi |  ubi adv.
ubicumque |  ubicumque (ubicunque,  арх.
Ubii |  Ubii, orum m
ubinam |  ubinam adv.
ubiquaque |  ubiquaque adv.
ubique |  ubique adv.
ubiubi |  ubiubi см.
ubivis |  ubivis adv.
udus |  udus, a, um поэт.
ulcero |  ulcero, (avi), atum, are
ulcerosus |  ulcerosus, a, um поэт.
ulciscor |  ulciscor, ultus sum, ulcisci
ulcus |  ulcus (hulcus), eris n
uligo |  uligo, inis f
Ulixes |  Ulixes, is (ei) m
ullus |  ullus, a, um gen.
ulmus |  ulmus, i f
ulna |  ulna, ae f
Ulnaceae |  Ulnaceae, arum f
ulnaris |  ulnaris, e анат.
ulnocarpeus |  ulnocarpeus, a, um анат.
ulter |  ulter, tra, trum compar.
ulterior |  ulterior, ius, gen.
ultimum |  I ultimum adv.
ultimus |  ultimus, a, um superl.
ultio |  ultio, onis f
ultor |  ultor, oris m
ultra |  I ultra adv.
Ultrabilum |  Ultrabil(um, i n
Ultracortenum |  Ultracorten(um, i n
Ultralanum |  Ultralan(um, i n
Ultranolum |  Ultranol(um, i n
Ultrasulfanum |  Ultrasulfan(um, i n
Ultrasulfonum |  Ultrasulfon(um, i n
ultrix |  ultrix, icis f
ultro |  ultro adv.
ulula |  ulula, ae f
ululatus |  ululatus, us m
ululo |  ululo, avi, atum, are поэт.
ulva |  ulva, ae f
umbellatus |  umbellatus, a, um биолог.
umbellifer |  umbellifer, era, erum
umbelliflorus |  umbelliflorus, a, um биолог.
umbilicalis |  umbilicalis, e анат.
umbilicus |  umbilicus, i m
umbo |  umbo, onis m
umbra |  umbra, ae f
umbraculum |  umbraculum, i n
Umbradilum |  Umbradil(um, i n
Umbragnostum |  Umbragnost(um, i n
Umbri |  Umbri, orum m
Umbria |  Umbria, ae f
umbrifer |  umbrifer, era, erum
umbro |  umbro, avi, atum, are
umbrosus |  umbrosus, a, um поэт.
ume |  ume...
umor |  umor
umquam |  umquam adv.
una |  una adv.
unanimitas |  unanimitas, atis f
unanimus |  unanimus, a, um
Unazidum |  Unazid(um, i n
uncia |  uncia, ae f
unciarius |  unciarius, a, um
unciformis |  unciformis, e анат.
uncinatus |  uncinatus, a, um анат.
unctio |  unctio, onis f
unctus |  unctus, a, um
uncus |  I uncus, a, um m
unda |  unda, ae f
unde |  unde adv.
undecies |  undecies (undeciens) adv.
undecim |  undecim
undecimus |  undecimus, a, um
Undecinum |  Undecin(um, i n
undeni |  undeni, ae, a
undeoctoginta |  undeoctoginta
undequinquagesimus |  undequinquagesimus, a, um
undequinquaginta |  undequinquaginta
undesexaginta |  undesexaginta
undetricesimus |  undetricesimus, a, um
undevicesimus |  undevicesimus (undevigesimus), a, um
undeviginti |  undeviginti
Undevitum |  Undevit(um, i n
undique |  undique adv.
undo |  undo, avi, atum, are поэт.
undosus |  undosus, a, um
unetvicesimani |  unetvicesimani, orum m
unetvicesimus |  unetvicesimus, a, um
ungo |  ungo (unguo), unxi, unctum, ere поэт.
ungualis |  ungualis, e анат.
Androfortum |  Androfort(um, i n
androgena |  androgena, orum n
androgenesis |  androgenesis, is f
androgenum |  androgenum, i n
Androgeos |  Androgeos (-eus), i m
androgynus |  androgynus, i m
Andromache |  Andromache, es f
Andromede |  Andromede, es f
Andronicus |  Andronicus, i m
Androralum |  Androral(um, i n
Andros |  Andros (-us), i f
Anectinum |  Anectin(um, i n
anellus |  anellus, i m
Anelmidum |  Anelmid(um, i n
anemophilus |  anemophilus, a, um бот.
Anemuriensis |  Anemuriensis, e
Anemurium |  Anemurium, i n
Anethinum |  Anethin(um, i n
anethum |  anethum, i n
Aneuralum |  Aneural(um, i n
Aneurinum |  Aneurin(um, i n
Aneurylum |  Aneuryl(um, i n
aneurysma |  aneurysma, atis n
anfractus |  anfractus, us m
anfugio |  anfugio, fugi, --, ere
Angiazolum |  Angiazol(um, i n
Angicapum |  Angicap(um, i n
angina |  angina, ae f
Angininum |  Anginin(um, i n
angiologia |  angiologia, ae f
Angiospermatophytina |  Angiospermatophytina, orum n
Angiotensinamidum |  Angiotensinamid(um, i n
Angiotrophinum |  Angiotrophin(um, i n
Angiovigorum |  Angiovigor(um, i n
angiportum |  angiportum, i n
Anglia |  Anglia, ae f
ango |  ango, anxi, (anctum pass.
angor |  angor, oris m
Angorminum |  Angormin(um, i n
anguicomus |  anguicomus, a, um поэт.
anguifer |  anguifer, era, erum поэт.
anguigena |  anguigena, ae m
anguilla |  anguilla, ae f
anguineus |  anguineus, a, um поэт.
anguipes |  anguipes, edis m
anguis |  anguis, is m
anguitenens |  anguitenens, entis m
angularis |  angularis, e
angulatus |  angulatus, a, um
angulus |  angulus, i m
angustia |  angustia, ae f
angustofolius |  angustofolius, a, um
angustum |  angustum, i n
angustus |  angustus, a, um
anhelitus |  anhelitus, us m
anhelo |  anhelo, avi, atum, are
anhelus |  anhelus, a, um
anhydricus |  anhydricus, а, um
Anicarum |  Anicar(um, i n
Anicianus |  Anicianus, a, um
Anicius |  Anicius, a, um
anicula |  anicula, ae f
Anien |  Anien, enis m
Aniensis |  Aniensis, e
Anienus |  Anienus, a, um
Anigrus |  Anigrus, i m
anilis |  anilis, e
anima |  anima, ae f
animadversio |  animadversio, onis f
animadverto |  animadverto, verti, versum, ere
animal |  animal, alis n
animans |  animans, antis adj.
animatus |  animatus, a, um
animo |  animo, avi, atum, are
animose |  animose adv.
animosus |  animosus, a, um
animus |  animus, i m
Anio |  Anio, enis m
anisantha |  anisantha, ae f
anisatus |  anisatus, а, um бот.
anisum |  anisum, i n
Anius |  Anius, i m
Anna |  Anna, ae f
annalis |  I annalis, e pl.
annascor |  annascor
anne |  anne
annecto |  annecto, nexui, nexum, ere
annellus |  annellus, i m
annexivus |  annexivus, a, um
annexus |  annexus, us m
Annianus |  Annianus, а, um
Annibal |  Annibal
Annicerii |  Annicerii, orum m
anniculus |  anniculus, a, um
annitor |  annitor, nisus (nixus) sum, niti
Annius |  Annius, а, um
anniversarius |  anniversarius, a, um
Anno |  Anno
anno |  anno, avi, atum, are
annon |  annon
annona |  annona, ae f
annosus |  annosus, a, um поэт.
annotinus |  annotinus, a, um
annul |  annul...
annularis |  annularis, e
annumero |  annumero, avi, atum, are
annuo |  annuo, nui, nutum, ere
annus |  annus, i m
annuus |  annuus, a, um бот.
anococcygeus |  anococcygeus, a, um анат.
anodonta |  anodonta, ae f
Anodyninum |  Anodynin(um, i n
anonymus |  anonymus, a, um
anopheles |  anopheles, is f
anorectalis |  anorectalis, e анат.
Anorexum |  Anorex(um, i n
Anormonum |  Anormon(um, i n
anquiro |  anquiro, quisivi, quisitum, ere
ansa |  ansa, ae f
anser |  anser, eris m
anserinus |  anserinus, a, um
Ansiacalum |  Ansiacal(um, i n
Antabusum |  Antabus(um, i n
Antaethanum |  Antaethan(um, i n
Antaethylum |  Antaethyl(um, i n
Antandrius |  Antandrius, a, um
Antandros |  Antandros (-us), i f
Antasthmanum |  Antasthman(um, i n
Antasthminum |  Antasthmin(um, i n
ante |  I ante praep.
antea |  antea adv.
Antebolinum |  Antebolin(um, i n
antebrachium |  antebrachium, i n
antecapio |  antecapio, cepi, ceptum (captum), ere
antecedo |  antecedo, cessi, cessum, ere
antecello |  antecello, --, --, ere
antecursor |  antecursor, oris m
anteeo |  anteeo, ivi (ii), --, ire
antefero |  antefero, tuli, latum, ferre
antefixa |  antefixa, orum n
antefixus |  antefixus, a, um
anteflexio |  anteflexio, onis f
antehac |  antehac adv.
antelucanus |  antelucanus, a, um
antemitto |  antemitto, misi, missum, ere
antemna |  antemna, ae f
Antemnae |  Antemnae, arum f
Antemnates |  Antemnates, ium m
antenna |  antenna, ae f
Antenor |  Antenor, oris m
Antenorides |  Antenorides, ae m
Anteparum |  Antepar(um, i n
antepes |  antepes, edis m
antepilani |  antepilani, orum m
antepono |  antepono, posui, positum, ere
antepositio |  antepositio, onis f
antequam |  antequam conj.
anterior |  anterior, ius
anterobasalis |  anterobasalis, e анат.
Anteros |  Anteros, otis m
antes |  antes, ium m
antesignanum |  antesignanum, i m
antesto |  antesto (antisto), steti (stiti), --, are
antestor |  antestor, atus sum, ari
antevenio |  antevenio, veni, ventum, ire
anteversio |  anteversio, onis f
anteverto |  anteverto, verti, versum, ere
Anthedon |  Anthedon, onis f
anthelix |  anthelix, icis f
Anthemusia |  Anthemusia, ae f
Anthiphenum |  Anthiphen(um, i n
anthotaxis |  anthotaxis, is f
anthropogenesis |  anthropogenesis, is f
anthropogenus |  anthropogenus, a, um
anthropologus |  anthropologus, i m
anthropomorphus |  anthropomorphus, a, um
antiae |  antiae, arum f
Antiallersinum |  Antiallersin(um, i n
Antianaeminum |  Antianaemin(um, i n
Antianus |  Antianus, а, um
Antias |  Antias, atis
antiasthmaticus |  antiasthmaticus, а, um мед.
Antiasthmocrinum |  Antiasthmocrin(um, i n
Antiates |  Antiates, ium m
Antiatinus |  Antiatinus, a, um
Antibasonum |  Antibason(um, i n
Anticandinum |  Anticandin(um, i n
Anticatabolinum |  Anticatabolin(um, i n
anticipo |  anticipo, avi, atum, are
Anticlea |  Anticlea, ae f
Anticolum |  Anticol(um, i n
anticorpus |  anticorpus, oris n
Anticyra |  Anticyra, ae f
antidea |  antidea adv.
Antidepressinum |  Antidepressin(um, i n
Antideprinum |  Antideprin(um, i n
antidotum |  antidotum, i n
Antiensis |  Antiensis, e
Antiforminum |  Antiformin(um, i n
Antigone |  Antigone, es f
Antigonea |  Antigonea, ae f
Antigonensis |  Antigonensis, e
Antigonus |  Antigonus, i m
Antihistaminum |  Antihistamin(um, i n
Antilibanus |  Antilibanus, i m
Antilochus |  Antilochus, i m
Antimachus |  Antimachus, i m
Antinous |  Antinous, i m
Antiochia |  Antiochia (-ea), ae f
Antiochius |  Antiochius (-eus или inus), a, um
Antiochus |  Antiochus, i m
Antiohenses |  Antiohenses, ium m
Antiohinus |  Antiohinus, a, um
Antiopa |  Antiopa, ae f
Antiparkinum |  Antiparkin(um, i n
Antiparum |  Antipar(um, i n
Antipater |  Antipater, tri m
Antipatria |  Antipatria, ae f
Antipernicinum |  Antipernicin(um, i n
Antiphates |  Antiphates, ae m
Antiphon |  Antiphon, ontis m
Antipolis |  Antipolis, is f
Antipsoriaticum |  Antipsoriatic(um, i n
Antipyrinum |  Antipyrin(um, i n
antique |  antique adv.
antiqui |  antiqui, orum m
antiquitas |  antiquitas, atis f
antiquitates |  antiquitates, um f
antiquitus |  antiquitus adv.
antiquo |  antiquo, avi, atum, are
antiquus |  antiquus, a, um compar.
antirabicus |  antirabicus, a, um фармац.
Antiroidum |  Antiroid(um, i n
antisepticus |  antisepticus, а, um мед.
Antisolonum |  Antisolon(um, i n
Antissa |  Antissa, ae f
Antissaei |  Antissaei, orum m
Antistenocardinum |  Antistenocardin(um, i n
Antisterolum |  Antisterol(um, i n
antistes |  antistes, itis m
Antisthenes |  Antisthenes, is m
antistita |  antistita, ae f
antisto |  antisto
Antistruminum |  Antistrumin(um, i n
Antisympathinum |  Antisympathin(um, i n
Antithrombosinum |  Antithrombosin(um, i n
antitragicus |  antitragicus, a, um анат.
antitragus |  antitragus, i m
Antium |  Antium, i n
Antiverrucinum |  Antiverrucin(um, i n
Antonianus |  Antonianus, а, um
Antoninus |  Antoninus, i m
Antonius |  Antonius, a, um
Antorphinum |  Antorphin(um, i n
Antoxolum |  Antoxol(um, i n
Antrenylum |  Antrenyl(um, i n
Antron |  Antron, onis ( acc.
antrum |  antrum, i n
Anturanilum |  Anturanil(um, i n
Anturanum |  Anturan(um, i n
Anturidinum |  Anturidin(um, i n
Anubis |  Anubis, idis ( acc.
anularis |  anularis, e
anularius |  I anularius, a, um m
anulatus |  anulatus, a, um
anulus |  anulus, i m
anurus |  anurus, a, um зоолог.
anus |  I anus, i m
Anusolum |  Anusol(um, i n
anxietas |  anxietas, atis f
anxius |  anxius, a, um
Anxur |  Anxur, uris n
Anxuras |  Anxuras, atis
Anytus |  Anytus, i m
Aoleptum |  Aolept(um, i n
Aon |  Aon, onis m
Aones |  Aones, um acc.
Aonia |  Aonia, ae f
Aonides |  Aonides, um f
Aonius |  Aonius, a, um
Aornis |  Aornis, idis ( acc.
Aornos |  Aornos, i m
aorta |  aorta, ae f
aorticus |  aorticus, a, um анат.
Aous |  Aous, i m
Apacilum |  Apacil(um, i n
Apamea |  Apamea (-ia), ae f
Apamensis |  Apamensis, e
Apamidum |  Apamid(um, i n
Aparkanum |  Aparkan(um, i n
Apaurinum |  Apaurin(um, i n
Apavortene |  Apavortene, es f
Apelarginum |  Apelargin(um, i n
Apella |  Apella, ae m
Apelles |  Apelles, is m
Apelleus |  Apelleus, a, um
Apennin |  Apennin... см.
aper |  aper, pri m
Aperantia |  Aperantia, ae f
Aperantii |  Aperantii, orum m
aperio |  aperio, perui, pertum, ire pass.
aperte |  aperte adv.
apertum |  apertum, i n
apertura |  apertura, ae f
apertus |  apertus, a, um
Apesanum |  Apesan(um, i n
apex |  apex, icis m
Apharejus |  Apharejus, a, um
Aphareus |  Aphareus (=Aphare^us), ei m
Aphrodisias |  Aphrodisias, adis f
Aphrodisienses |  Aphrodisienses, ium m
aphyllus |  aphyllus, a, um бот.
apicalis |  apicalis, e
apicatus |  apicatus, a, um
Apicius |  Apicius, i m
Apicodinum |  Apicodin(um, i n
Apicosanum |  Apicosan(um, i n
Apicurum |  Apicur(um, i n
Apidanus |  Apidanus, i m
Apilacum |  Apilac(um, i n
Apiolae |  Apiolae, arum f
Apion |  Apio(n), onis m
Apiphorum |  Apiphor(um, i n
apis |  I apis, is f
Apisarthronum |  Apisarthron(um, i n
apiscor |  apiscor, aptus sum, apisci
Apitritum |  Apitrit(um, i n
apium |  apium, i n
Apivenum |  Apiven(um, i n
apocleti |  apocleti, orum m
apocrinus |  apocrinus, a, um анат.
Apollinare |  Apollinare, is n
Apollinaris |  Apollinaris, e
Apollineus |  Apollineus, a, um
Apollo |  Apollo, inis m
Apollodorei |  Apollodorei, orum m
Apollodorus |  Apollodorus, i m
Apollonia |  Apollonia, ae f
Apolloniatae |  Apolloniatae, arum m
Apolloniates |  Apolloniates, ium (um) m
Apollonidenses |  Apollonidenses, ium m
Apollonienses |  Apollonienses, ium m
Apolloniensis |  Apolloniensis, e
Apollonis |  Apollonis, idis f
Apollonius |  Apollonius, i m
Apomorphinum |  Apomorphin(um, i n
aponeurosis |  aponeurosis, is f
aponeuroticus |  aponeuroticus, a, um анат.
apophysis |  apophysis, is f
apotheca |  apotheca, ae f
apparate |  apparate adv.
apparatus |  I apparatus, a, um m
appareo |  appareo, ui, itum, ere part.
apparitor |  apparitor, oris m
apparo |  apparo, avi, atum, are
appellatio |  appellatio, onis f
appellator |  appellator, oris m
appello |  I appello, avi, atum, are юр.
appendicula |  appendicula, ae f
appendicularis |  appendicularis, e анат.
appendix |  appendix, icis f
appendo |  appendo, pendi, pensum, ere
Appenninicola |  Appenninicola, ae m
Appenninigena |  Appenninigena, ae m
Appenninus |  Appenninus, i m
appetens |  appetens, entis
appeto |  appeto, ivi (ii), itum, ere
Appia |  Appia, ae f
Appiani |  Appiani, orum m
Appianus |  Appianus, a, um
Appias |  Appias, adis f
Appietas |  Appietas, atis f
appingo |  appingo, pinxi, pictum, ere
Appius |  Appius, a, um
applaudo |  applaudo, plausi, plausum, ere
applicatio |  applicatio, onis f
applicatus |  applicatus, a, um
applico |  applico, avi (ui), atum (itum), are
apploro |  apploro, avi, --, are
appono |  appono, posui, positum, ere
apporrectus |  apporrectus, a, um
apporto |  apporto, avi, atum, are
apposco |  apposco, --, --, ere
appositus |  appositus, a, um
apprecor |  apprecor, atus sum, ari
apprehendo |  apprehendo (apprendo), prehendi (prendi), prehensum (prensum), ere
apprime |  apprime adv.
approbatio |  approbatio, onis f
approbo |  approbo, avi, atum, are
appromitto |  appromitto, misi, missum, ere
appropero |  appropero, avi, atum, are
appropinquatio |  appropinquatio, onis f
appropinquo |  appropinquo, avi, atum, are
Appul |  Appul...
appulsus |  appulsus, us m
Apressinum |  Apressin(um, i n
apricum |  apricum, i n
apricus |  apricus, a, um
Aprilis |  I Aprilis, e m
Apronianus |  Apronianus, a, um
Apronius |  Apronius, i m
Aprophenum |  Aprophen(um, i n
Apsus |  Apsus, i m
apte |  apte adv.
apto |  apto, avi, atum, are
aptus |  aptus, a, um
apud |  apud praep.
Apulejus |  Apulejus, a, um
Apuli |  Apuli, orum m
Apulia |  Apulia, ae f
Apulicus |  Apulicus, a, um
Apulus |  Apulus, a, um
aqua |  aqua, ae f
aquaeductus |  aquaeductus, us m
aqualis |  aqualis, is m
Aqualonum |  Aqualon(um, i n
aquanauta |  aquanauta, ae m
aquarium |  aquarium, i n
aquarius |  I aquarius, a, um m
aquaticus |  aquaticus, a, um
aquatio |  aquatio, onis f
aquator |  aquator, oris m
aqueus |  aqueus, a, um
aquila |  aquila, ae f
Aquilaria |  Aquilaria, ae f
Aquileja |  Aquileja, ae f
Aquilejenses |  Aquilejenses, ium m
Aquilejensis |  Aquilejensis, e
aquilifer |  aquilifer, eri m
Aquill |  Aquil(l)ius, a, um
Aquillianus |  Aquillianus, a, um
aquilo |  aquilo, onis m
Aquilonia |  Aquilonia, ae f
Aquinas |  Aquinas, atis
Aquinates |  Aquinates, ium m
Aquinum |  Aquinum, i n
Aquitani |  Aquitani, orum m
Aquitania |  Aquitania, ae f
Aquitanus |  Aquitanus, a, um
aquor |  aquor, atus sum, ari
aquosus |  aquosus, a, um
ara |  ara, ae f
arabarches |  arabarches, ae m
Arabia |  Arabia, ae f
Arabic |  Arabi(c)us, a, um
Arabs |  I Arabs, abis m
Arabus |  I Arabus, а, um m
Arachidenum |  Arachiden(um, i n
Arachne |  Arachne, es f
Arachnida |  Arachnida, orum n
arachnoidea |  arachnoidea, ае f
arachnoidealis |  arachnoidealis, e анат.
arachnoideus |  arachnoideus, a, um
Arachosia |  Arachosia, ae f
Arachosii |  Arachosii, orum m
Arachthus |  Arachthus, i m
Aracynthus |  Aracynthus, i m
Aradus |  Aradus, i f
Aralenum |  Aralen(um, i n
aralia |  aralia, ae f
arancium |  arancium, i n
aranea |  aranea, ae f
araneolus |  araneolus, i m
araneomorphus |  araneomorphus, a, um зоолог.
Arar |  Arar, aris acc.
Araris |  Araris
Arateus |  Arateus, a, um
aratio |  aratio, onis f
Aratius |  Aratius, a, um
arator |  arator, oris m
aratrum |  aratrum, i n
Aratthus |  Aratthus, i m
Aratus |  Aratus, i m
Araxes |  Araxes, is ( acc.
Arbela |  Arbela, orum n
arbiter |  arbiter, tri m
arbitra |  arbitra, ae f
arbitratus |  arbitratus, us m
arbitrium |  arbitrium, i n
arbitror |  arbitror, atus sum, ari
arbor |  arbor, oris f
arborescens |  arborescens, entis бот.
arboreus |  arboreus, a, um
arbos |  arbos, oris f
Arbuscula |  Arbuscula, ae f
arbustum |  arbustum, i n
arbuteus |  arbuteus, a, am
arbutum |  arbutum, i n
arbutus |  arbutus, i f
arca |  arca, ae f
Arcadia |  Arcadia, ae f
Arcadic |  Arcadi(c)us, a, um
arcano |  arcano adv.
arcanum |  I arcanum, i n
arcanus |  arcanus, a, um
Arcas |  I Arcas, adis m
arceo |  arceo, ui, --, ere
Arcesilas |  Arcesilas, ae m
Arcesius |  Arcesius, i m
arcesso |  arcesso, ivi, itum, ere юр.
Arche |  Arche, es f
Archelaus |  Archelaus, i m
Archiacus |  Archiacus, a, um
Archias |  Archias, ae m
archicerebellum |  archicerebellum, i n
archicortex |  archicortex, icis m
Archilochius |  Archilochius, a, um
Archilochus |  Archilochus, i m
Archimedes |  Archimedes, is ( acc.
archipallium |  archipallium, i n
archipirata |  archipirata, ae m
architectus |  architectus, i m
archon |  archon, ontis m
Archytas |  Archytas, ae m
arciformis |  arciformis, e
arcitenens |  arcitenens ( арх.
Arcodexanum |  Arcodexan(um, i n
Arcortum |  Arcort(um, i n
Arcosalum |  Arcosal(um, i n
arcte |  arcte
Arctica |  Arctica, ae f
arcticus |  arcticus, a, um
arcto |  arcto
Arctophylax |  Arctophylax, acis m
Arctos |  Arctos, i f
arctus |  I arctus, a, um f
arcuarius |  arcuarius, a, um
arcuatus |  I arcuatus (arquatus), a, um
arcus |  arcus ( арх.
Ardcas |  Ardcas, atis
ardea |  I ardea, ae f
Ardeates |  Ardeates, ium m
Ardeatinum |  Ardeatinum, i n
Ardeatinus |  Ardeatinus, a, um
ardens |  ardens, entis
ardeo |  ardeo, arsi, arsum, ere
ardesco |  ardesco, arsi, --, ere
ardor |  ardor, oris m
Arduenna |  Arduenna, ae f
arduum |  arduum, i n
arduus |  arduus, a, um
area |  area, ae f
Arechinum |  Arechin(um, i n
Arelate |  Arelate, is n
arena |  arena (harena), ae f
Arenacum |  Arenacum, i n
arenaria |  arenaria, ae f
arenicola |  arenicola, ae m
arenosus |  arenosus, a, um
arens |  arens, entis
areo |  areo, rui, --, ere
areola |  areola, ае f
areolaris |  areolaris, e анат.
Areopagita |  Areopagita (-es), аe m
Areopagus |  Areopagus (-os), i m
aresco |  aresco, arui, --, ere
Arestorides |  Arestorides, ae, m
Arete |  Arete, es f
Arethusa |  Arethusa, ae f
Arethusis |  Arethusis, idis
Arfonadum |  Arfonad(um, i n
Arganthonius |  Arganthonius, i m
Arganthus |  Arganthus, i m
Argei |  Argei, orum m
Argentanum |  Argentanum, i n
argentaria |  argentaria, ae f
argentarius |  I argentarius, a, um m
argentatus |  argentatus, a, um
argenteus |  argenteus, a, um поэт.
Argentoratensis |  Argentoratensis, e
Argentoratus |  Argentoratus, i f
argentum |  argentum, i n
argestes |  argestes, ae m
Argeus |  Argeus, a, um поэт.
Argiletanus |  Argiletanus, a, um
Argiletum |  Argiletum, i n
argilla |  argilla, ae f
Arginuss |  Arginus(s)ae, arum f
Argivi |  Argivi, orum m
Argivus |  Argivus, a, um поэт.
Argo |  Argo, us acc.
Argolicus |  Argolicus, a, um поэт.
Argolis |  Argolis, idis f
Argonautae |  Argonautae, arum m
Argonautica |  Argonautica, orum n
Argos |  I Argos indecl.
Argous |  Argous, a, um
argumentatio |  argumentatio, onis f
argumentor |  argumentor, atus sum, ari
argumentum |  argumentum, i n
arguo |  arguo, ui, utum (arguiturus), ere
Argus |  Argus, i m
argute |  argute adv.
argutiae |  argutiae, arum f
argutus |  argutus, a, um
argyraspis |  argyraspis, idis m
Aria |  Aria, ae f
Ariadna |  Ariadna, ae f
Ariadnaeus |  Ariadnaeus, a, um
Arialerginum |  Arialergin(um, i n
Ariana |  Ariana, ae f
Ariarathes |  Ariarathes, is ( acc.
Aricia |  Aricia, ae f
Aricini |  Aricini, orum m
Aricinus |  Aricinus, a, um
aridum |  aridum, i n
aridus |  aridus, a, um
ariena |  ariena, ae f
aries |  aries, etis m
arieto |  arieto, avi, atum, are
Arii |  Arii, orum m
Ariminenses |  Ariminenses, ium m
Ariminum |  Ariminum, i n
Ariobarzanes |  Ariobarzanes, is m
ariol |  ariol...
Arion |  Arion m
Arionius |  Arionius, a, um
Ariovistus |  Ariovistus, i m
Arisba |  Arisba, ae f
arista |  arista, ae f
Aristaeus |  Aristaeus, i m
Aristarchus |  Aristarchus, i m
Aristides |  Aristides, is m
Aristinum |  Aristin(um, i n
Aristippeus |  Aristippeus, a, um
Aristippus |  Aristippus, i m
Aristius |  Aristius, i m
Aristo |  Aristo m
Aristocortum |  Aristocort(um, i n
Aristodemus |  Aristodemus, i m
Aristogiton |  Aristogiton, onis m
Aristomache |  Aristomache, es f
Aristoneus |  Aristoneus, a, um
Aristonicus |  Aristonicus, i m
Aristophanes |  Aristophanes, is m
Aristophaneus |  Aristophaneus, a, um
Aristophyllinum |  Aristophyllin(um, i n
Aristoteles |  Aristoteles, is acc.
Aristoteleus |  Aristoteleus, a, um
Aristoxenus |  Aristoxenus, i m
Aristus |  Aristus, i m
Ariusium |  Ariusium, i n
Ariusius |  Ariusius, a, um
arma |  arma, orum n
armamenta |  armamenta, orum n
armamentarium |  armamentarium, i n
armarium |  armarium, i n
armatura |  armatura, ae f
armatus |  I armatus, a, um m
Armazalum |  Armazal(um, i n
Armenia |  Armenia, ae f
armeniaca |  armeniaca, ae f
Armenii |  Armenii, orum m
Armenius |  Armenius, a, um
armentalis |  armentalis, e
armentarius |  armentarius, i m
armentum |  armentum, i n
armifer |  armifer, era, erum
armiger |  I armiger, era, erum m
armigera |  armigera, ae f
armilla |  armilla, ae f
Arminius |  Arminius, i m
Arminum |  Armin(um, i n
armipotens |  armipotens, entis поэт.
armisonus |  armisonus, a, um поэт.
armo |  armo, avi, atum, are
armus |  armus, i m
arnica |  arnica, ae f
Arniensis |  Arniensis, e
Arnus |  Arnus, i m
aro |  aro, avi, atum, are поэт.
Aromaronum |  Aromaron(um, i n
aromaticus |  aromaticus, а, um
Arpenalum |  Arpenal(um, i n
Arpi |  Arpi, orum m
Arpinas |  I Arpinas, atis m
Arpinates |  Arpinates, ium m
Arpini |  Arpini, orum m
Arpinum |  Arpinum, i n
Arpinus |  Arpinus, a, um
arqu |  arqu...
arrector |  arrector, oris m
arrectus |  arrectus, a, um
arrepo |  arrepo, repsi, reptum, ere
Arretini |  Arretini, orum m
Arretinus |  Arretinus, a, um
Arretium |  Arretium, i n
arrideo |  arrideo, risi, risum, ere
arrigo |  arrigo, rexi, rectum, ere
arripio |  arripio, ripui, reptum, ere
arrodo |  arrodo, rosi, rosum, ere
arrogans |  arrogans, antis
arroganter |  arroganter adv.
arrogantia |  arrogantia, ae f
arrogo |  arrogo, avi, atum, are
ars |  ars, artis f
Arsaces |  Arsaces, is ( acc.
Arsacides |  Arsacides, ae m
Arsaphenum |  Arsaphen(um, i n
arsenas |  arsenas, atis m
arsenicosus |  arsenicosus, a, um хим.
Arsenicum |  Arsenicum, i n
arsenis |  arsenis, itis m
Arsia |  Arsia, ae f
Arsinoe |  Arsinoe, es f
Artabanus |  Artabanus, i m
Artacie |  Artacie, es f
Artanum |  Artan(um, i n
Artaphernes |  Artaphernes, is ( acc.
Artavasdes |  Artavasdes, is ( acc.
Artaxata |  Artaxata, orum n
Artaxerxes |  Artaxerxes, is ( acc.
arte |  arte adv.
artemisia |  artemisia, ae f
Artemisium |  Artemisium, i n
Artemisolum |  Artemisol(um, i n
Arterenolum |  Arterenol(um, i n
arteria |  arteria, ае f
arterialis |  arterialis, e мед.
Arteriodonum |  Arteriodon(um, i n
arteriola |  arteriola, ae f
arteriolovenularis |  arteriolovenularis, e анат.
arteriosus |  arteriosus, a, um анат.
arthrologia |  arthrologia, ae f
arthron |  arthron, i n
Arthropoda |  Arthropoda, orum n
arthropodus |  arthropodus, a, um зоолог.
arthrotomia |  arthrotomia, ae f
articularis |  articularis, e
articulatio |  articulatio, onis f
articulus |  articulus, i m
artifex |  artifex, icis adj.
artificialis |  artificialis, e
artificium |  artificium, i n
arto |  arto, avi, atum, are
artocreas |  artocreas, atis n
Artosinum |  Artosin(um, i n
Artrichinum |  Artrichin(um, i n
Artriphanum |  Artriphan(um, i n
Artrizinum |  Artrizin(um, i n
Artrochinum |  Artrochin(um, i n
artum |  artum, i n
artus |  I artus, a, um pl.
arula |  arula, ae f
arundifer |  arundifer, era, erum поэт.
arundineus |  arundineus, a, um
arundo |  arundo, inis f
Arusalum |  Arusal(um, i n
arusp |  arusp...
arvensis |  arvensis, e биолог.
Arverni |  Arverni, orum m
arvina |  arvina, ae f
arvum |  arvum, i n
arvus |  arvus, a, um
arx |  arx, arcis f
aryepiglotticus |  aryepiglotticus, a, um анат.
arytena |  arytena, ae f
arytenoideus |  arytenoideus, a, um анат.
Arytmalum |  Arytmal(um, i n
aryvocalis |  aryvocalis, e анат.
as |  as, assis m
Asalinum |  Asalin(um, i n
Asamidum |  Asamid(um, i n
ascaris |  ascaris, idis f
ascendens |  ascendens, entis
ascendo |  ascendo, scendi, scensum, ere
ascensus |  ascensus, us m
ascio |  ascio (adscio), --, --, ire
ascisco |  ascisco (adscisco), ivi, itum, ere
ascitus |  ascitus, a, um
Asclepiades |  Asclepiades, ae m
Ascomycetes |  Ascomycetes, um m
Ascophenum |  Ascophen(um, i n
ascorbinas |  ascorbinas, atis m
ascorbinicus |  ascorbinicus, a, um хим.
Ascorbinum |  Ascorbin(um, i n
Ascorbitum |  Ascorbit(um, i n
Ascorutinum |  Ascorutin(um, i n
Ascorvitum |  Ascorvit(um, i n
Ascra |  Ascra, ae f
Ascraeus |  Ascraeus, a, um
ascribo |  ascribo (adscribo), scripsi, scriptum, ere
ascriptio |  ascriptio, onis f
ascriptor |  ascriptor, oris m
Asculani |  Asculani, orum m
Asculanus |  Asculanus, a, um
Asculum |  Asculum, i n
asella |  asella, ae f
asellus |  asellus, i m
Aseptilexum |  Aseptilex(um, i n
Aseptilguanidinum |  Aseptilguanidin(um, i n
asexualis |  asexualis, e биолог.
Asia |  Asia, ae f
Asiaganes |  Asiaganes, is m
Asiani |  Asiani, orum m
Asianus |  Asianus, a, um
Asiaticus |  Asiaticus, a, um
asilus |  asilus, i m
Asinius |  Asinius, a, um
asinus |  asinus, i m
Asis |  Asis, idis acc.
Asitinum |  Asitin(um, i n
Asius |  Asius, a, um
Asnitinum |  Asnitin(um, i n
Asopiades |  Asopiades, ae m
Asopis |  Asopis, idis f
Asopus |  Asopus, i m
asotus |  asotus, i m
Asparagium |  Asparagium, i n
aspargo |  aspargo, inis f
Aspasia |  Aspasia, ae f
Aspavia |  Aspavia, ae f
aspectabilis |  aspectabilis, e
aspecto |  aspecto, avi, atum, are
aspectus |  aspectus, us m
Aspendii |  Aspendii, orum m
Aspendius |  Aspendius, a, um
Aspendus |  Aspendus (-os), i f
asper |  asper, era, erum
aspera |  aspera, orum n
aspere |  aspere adv.
aspergo |  I aspergo (adspergo), spersi, spersum, ere f
asperitas |  asperitas, atis f
aspernor |  aspernor (adspernor), atus sum, ari
aspero |  aspero, avi, atum, are
aspersio |  aspersio, onis f
Asphalites |  Asphalites (lacus), ae f
asphaltus |  asphaltus, i m
Asphenum |  Asphen(um, i n
aspicio |  aspicio (adspicio), spexi, spectum, ere
aspirans |  aspirans, antis m
aspirantura |  aspirantura, ae f
Aspirinum |  Aspirin(um, i n
aspiro |  aspiro (adspiro), avi, atum, are
aspis |  aspis, idis f
asportatio |  asportatio, onis f
asporto |  asporto (absporto), avi, atum, are
aspretum |  aspretum, i n
Assaracus |  Assaracus, i m
assecla |  assecla или assecula, ae m
assectatio |  assectatio, onis f
assectator |  assectator, oris m
assector |  assector, atus sum, ari
assecula |  assecula, ae f
assensio |  assensio, onis f
assensus |  assensus, us m
assentatio |  assentatio, onis f
assentator |  assentator, oris m
assentior |  assentior, sensus sum, iri,  арх.
assentor |  assentor, atus sum, ari
assequor |  assequor (adsequor), secutus (sequutus) sum, sequi
asser |  asser, eris m
assero |  I assero (adsero), serui, sertum, ere юр.
assertor |  assertor, oris m
asservo |  asservo (adservo), avi, atum, are
asseveratio |  asseveratio, onis f
assevero |  assevero (adsevero), avi, atum, are
assideo |  assideo (adsideo), sedi, sessum, ere воен.
assido |  assido (adsido), sedi, sessum, ere
assidue |  assidue adv.
assiduitas |  assiduitas, atis f
assiduus |  I assiduus, a, um m
assignatio |  assignatio, onis f
assigno |  assigno (adsigno), avi, atum, are
assilio |  assilio (adsilio), silui, sultum, ire
assimilis |  assimilis, e
assimulatus |  assimulatus, a, um
assimulo |  assimulo (adsimulo), avi, atum, are
assis |  assis, is m
assisto |  assisto (adsisto), astiti, --, ere
associatio |  associatio, onis f
associus |  associus, a, um
assoleo |  assoleo (adsoleo), --, --, ere
assono |  assono (adsono), --, --, are
assuefacio |  assuefacio (adsuefacio), feci, factum, ere
assuesco |  assuesco (adsuesco), suevi, suetum, ere
assuetudo |  assuetudo, inis f
assuetus |  I assuetus, a, um
assultus |  assultus, us m
assum |  I assum (adsum), affui (adfui), adesse юр.
assumo |  assumo (adsumo), sumpsi, sumptum, ere
assuo |  assuo (adsuo), sui, sutum, ere
assurgo |  assurgo (adsurgo), surrexi, surrectum, ere поэт.
assus |  assus, a, um
Assyria |  Assyria, ae f
Assyrii |  Assyrii, orum m
Assyrius |  Assyrius, a, um поэт.
ast |  ast conj.
Asta |  Asta, ae f
Astacides |  Astacides, ae m
Astacus |  Astacus, i m
Astapa |  Astapa, ae f
Astarte |  Astarte, es f
Astensis |  Astensis, e
Asteria |  Asteria, ae f
astericus |  astericus, a, um анат.
asterno |  asterno (adsterno), --, astratum, ere pass.
Asterolum |  Asterol(um, i n
Asthima |  Asthima-spreu фармац.
Asthiminum |  Asthimin(um, i n
Asthmatinum |  Asthmatin(um, i n
Asthmatolum |  Asthmatol(um, i n
astipulatur |  astipulatur, oris m
astipulor |  astipulor (adstipulor), atus sum, ari
asto |  asto (adsto), iti, (astatum или astitum), are
Astracainum |  Astracain(um, i n
Astraea |  Astraea, ae f
Astraeus |  Astraeus, i m
astragalocalcaneus |  astragalocalcaneus, a, um анат.
astragalus |  astragalus, i m
astrictus |  astrictus, a, um
astringo |  astringo (adstringo), strinxi, strictum, ere
astrologus |  astrologus, i m
astronauta |  astronauta, ae m
astrum |  astrum, i n
astruo |  astruo (adstruo), struxi, structum, ere
astu |  I astu adv.
astupeo |  astupeo (adstupeo), ui, --, ere
Astur |  I Astur, uris m
Astura |  Astura, ae m
asturco |  asturco, onis m
Astures |  Astures, um m
Asturia |  Asturia, ae f
Asturicus |  Asturicus, a, um
astus |  astus, us m
astute |  astute adv.
astutia |  astutia, ae f
astutus |  astutus, а, um
asty |  asty n
Astyanax |  Astyanax, actis ( acc.
Astypalaea |  Astypalaea, ae f
Astypalaeensis |  Astypalaeensis, e
Astypalejus |  Astypalejus, a, um
Asulenum |  Asulen(um, i n
asylum |  asylum, i n
at |  at ( арх.
Atabrinum |  Atabrin(um, i n
Atabulus |  I Atabulus, i m
Atalanta |  Atalanta, ae f
Atalantaeus |  Atalantaeus, a, um
Atalantiades |  Atalantiades, ae m
Atanagrum |  Atanagrum, i n
atavus |  atavus, i m
Atebrinum |  Atebrin(um, i n
ategen |  ategen, enis m
Atejus |  Atejus, i m
Atella |  Atella, ae f
Atellanicus |  Atellanicus, a, um
Atellanius |  Atellanius, a, um
Atellanus |  I Atellanus, a, um m
Atelorum |  Atelor(um, i n
ater |  ater, atra, atrum
Ateriosanum |  Ateriosan(um, i n
Ateste |  Ateste, is n
Athamanes |  Athamanes, um m
Athamania |  Athamania, ae f
Athamanteus |  Athamanteus, a, um
Athamantiades |  Athamantiades, ae m
Athamantis |  Athamantis, idos f
Athamas |  Athamas, antis m
Athenae |  Athenae, arum f
Athenaeum |  Athenaeum, i n
athene |  athene, es f
Atheniensis |  I Atheniensis, is m
Athenio |  Athenio, onis m
Athenodorus |  Athenodorus, i m
Athesis |  Athesis, is m
athleta |  athleta, ae m
Atho |  Atho или Athon, onis m
Athos |  Athos dat.
Athrombonum |  Athrombon(um, i n
Atilianus |  Atilianus, a, um
Atilius |  Atilius, a, um
Atina |  Atina, ae f
Atinas |  Atinas, atis abl.
Atinates |  Atinates, um m
Atintanes |  Atintanes, um m
Atintania |  Atintania, ae f
Atius |  Atius, a, um
Atlanteus |  Atlanteus, a, um
Atlantiacus |  Atlantiacus, a, um
Atlantiades |  Atlantiades, ae m
Atlantias |  Atlantias, adis f
Atlanticus |  Atlanticus, a, um
Atlantis |  Atlantis, idis f
atlantoaxialis |  atlantoaxialis, e анат.
Atlas |  I Atlas, antis ( acc.
Atocinum |  Atocin(um, i n
Atophanum |  Atophan(um, i n
Atosilum |  Atosil(um, i n
Atoxicainum |  Atoxicain(um, i n
atque |  atque conj.
atqui |  atqui conj.
Atracides |  Atracides, ae m
Atracis |  Atracis, idis f
Atracius |  Atracius, a, um поэт.
atramentum |  atramentum, i n
Atratus |  Atratus, i m
atratus |  atratus, a, um
Atrax |  Atrax, acis f
Atrebates |  Atrebates, um m
Atreyus |  Atreyus, ei ( acc.
Atrides |  Atrides, ae m
atriensis |  atriensis, is m
Atrifosum |  Atrifos(um, i n
atrioventricularis |  atrioventricularis, e анат.
Atriphosum |  Atriphos(um, i n
atrium |  atrium, i n
Atrivylum |  Atrivyl(um, i n
atrocitas |  atrocitas, atis f
atrociter |  atrociter adv.
atrofuscus |  atrofuscus, a, um
Atromidinum |  Atromidin(um, i n
Atropinum |  Atropin(um, i n
atropurpureus |  atropurpureus, a, um
atrox |  atrox, ocis
Atta |  Atta, ae m
attagen |  attagen, genis m
Attalenses |  Attalenses, ium m
Attalia |  Attalia, ae f
Attalicus |  Attalicus, a, um
Attalis |  Attalis, idis f
Attalus |  Attalus, i m
attamen |  attamen conj.
attempto |  attempto
attendo |  attendo, tendi, tentum, ere
attente |  attente adv.
attento |  attento (attempto), avi, atum, are
attentus |  attentus, a, um
attenuo |  attenuo, avi, atum, are
attero |  attero, trivi, tritum, ere поэт.
attexo |  attexo, texui, textum, ere
Atthis |  Atthis (Attis), idis f
Attianus |  Attianus, a, um
Attica |  Attica, ae f
Attici |  Attici, orum m
Atticus |  Atticus, a, um
Attilianus |  Attilianus, a, um
Attilius |  Attilius, a, um
attineo |  attineo, tinui, tentum, ere
attingo |  attingo, tigi, tactum, ere
Attius |  Attius, a, um
attollo |  attollo, --, --, ere pass.
attondeo |  attondeo, tondi, tonsum, ere
attonitus |  attonitus, a, um
attono |  attono, tonui, tonitum, are
attorqueo |  attorqueo, --, --, ere
attracto |  attracto
attraho |  attraho, traxi, tractum, ere
attrecto |  attrecto, avi, atum, are
attribuo |  attribuo, tribui, tributum, ere
attritus |  attritus, a, um
Aturbanum |  Aturban(um, i n
Atys |  Atys (Attys), yos ( abl.
auceps |  auceps, upis m
auctio |  auctio, onis f
auctionarius |  auctionarius, a, um
auctionor |  auctionor, atus sum, ari
auctor |  auctor, oris m
auctoramentum |  auctoramentum, i n
auctoritas |  auctoritas, atis f
auctoro |  auctoro, avi, atum, are
auctumn |  auctumn...
auctus |  I auctus, a, um преим.
aucupium |  aucupium, i n
aucupor |  aucupor, atus sum, ari
audacia |  audacia, ae f
audacter |  audacter (реже audaciter) adv.
audax |  audax, acis
audens |  audens, entis
audeo |  audeo, ausus sum, ere
audientia |  audientia, ae f
audio |  audio, ivi (ii), itum, ire
auditio |  auditio, onis f
auditivus |  auditivus, a, um
auditor |  auditor, oris m
auditum |  auditum, i n
auditus |  auditus, us m
aufero |  aufero, abstuli, ablatum, auferre
Aufidena |  Aufidena, ae f
Aufidianus |  Aufidianus, a, um
Aufidius |  Aufidius, a, um
Aufidus |  Aufidus, i m
Auge |  Auge, es f
augeo |  augeo, auxi, auctum, ere
augesco |  augesco, auxi, --, ere
Augias |  Augias (Augeas), ae m
augur |  augur, uris m
auguralis |  auguralis, e
auguratus |  auguratus, us m
augurium |  augurium, i n
augurius |  augurius, a, um
auguro |  auguro, avi, atum, are
auguror |  auguror, atus sum, ari
auguste |  auguste adv.
augustus |  I augustus, a, um m
aula |  aula, ae f
aulaeum |  aulaeum, i n
Aulerci |  Aulerci, orum m
aulicus |  I aulicus, a, um m
Aulis |  Aulis, idis f
auloedus |  auloedus, i m
Aulon |  Aulon, onis m
Aulus |  Aulus, i m
aura |  aura, ae f
auratus |  auratus, a, um
Aurelius |  Aurelius, a, um
Aureociclina |  Aureociclina, ae f
Aureomycinum |  Aureomycin(um, i n
Aureomykoinum |  Aureomykoin(um, i n
aureus |  I aureus, a, um поэт.
auricomus |  auricomus, a, um поэт.
auricula |  auricula, ae f
auricularis |  auricularis, e анат.
auriculotemporalis |  auriculotemporalis, e анат.
aurifer |  aurifer, era, erum
aurifex |  aurifex, icis m
auriga |  auriga, ae m
aurigena |  I aurigena, ae m
auris |  auris, is f
auritus |  auritus, a, um
aurora |  aurora, ae f
aurum |  aurum, i n
Aurunci |  Aurunci, orum m
Auruncus |  Auruncus, a, um
Ausa |  Ausa, ae f
Ausci |  Ausci, orum m
ausculto |  ausculto, avi, atum, are
Ausetani |  Ausetani, orum m
Ausetanus |  Ausetanus, a, um
Ausona |  Ausona, ae f
Ausones |  Ausones, um m
Ausonia |  Ausonia, ae f
Ausonidae |  Ausonidae, um m
Ausonis |  Ausonis, idis поэт.
Ausonius |  Ausonius, a, um поэт.
auspex |  auspex, icis m
auspicato |  auspicato adv.
auspicatus |  auspicatus, a, um
auspicium |  auspicium, i n
auspicor |  auspicor, atus sum, ari
auster |  auster, tri m
austere |  austere adv.
austerus |  austerus, a, um
Australia |  Australia, ae f
australis |  australis, e
Austrapenum |  Austrapen(um, i n
Austria |  Austria, ae f
ausum |  ausum, i n
aut |  aut conj.
autem |  autem conj.
authepsa |  authepsa, ae f
autobiographia |  autobiographia, ae f
autobirota |  autobirota, ae f
autochorus |  autochorus, i m
autocineticus |  autocineticus, a, um
autocinetodromus |  autocinetodromus, i m
autocinetum |  autocinetum, i n
autogenus |  autogenus, a, um биолог.
autoinfectio |  autoinfectio, onis f
autointoxicatio |  autointoxicatio, onis f
Autolycus |  Autolycus, i m
autolysis |  autolysis, is f
automaticus |  automaticus, a, um
automatum |  automatum, i n
Automedon |  Automedon, ontis m
Autonoe |  Autonoe, es f
autonomicus |  autonomicus, a, um анат.
autopodium |  autopodium, i n
autor |  autor...
autoraeda |  autoraeda, ae f
autotomia |  autotomia, ae f
autotransplantatio |  autotransplantatio, onis f
autumnalis |  autumnalis, e
autumnus |  I autumnus, a, um m
autumo |  autumo, avi, atum, are
auxiliares |  auxiliares, ium m
auxiliaris |  auxiliaris, e
auxiliarius |  auxiliarius, a, um
auxilior |  auxilior, atus sum, ari
auxilium |  auxilium, i n
Auximates |  Auximates, um m
Auximum |  Auximum, i n
Auxobilum |  Auxobil(um, i n
avare |  avare adv.
Avaricensis |  Avaricensis, e
Avaricum |  Avaricum, i n
avaritia |  avaritia, ae f
avarus |  avarus, a, um
aveho |  I aveho, vexi, vectum, ere pass.
Avella |  Avella, ae m
avello |  avello, velli (vulsi, volsi), vulsum, ere
avena |  avena, ae f
Aventinum |  Aventinum, i n
Aventinus |  I Aventinus, a, um m
aveo |  I aveo (haveo), --, --, ere
Avernalis |  Avernalis, e
Avernus |  I Avernus, i m
averro |  averro, verri, --, ere
averrunco |  averrunco, --, --, are
aversa |  aversa, orum n
Aversanum |  Aversan(um, i n
aversor |  I aversor, atus sum, ari m
aversus |  aversus, a, um
averto |  averto, verti, versum, ere
avia |  avia, ae f
aviarium |  aviarium, i n
aviator |  aviator, oris m
aviatorius |  aviatorius, a, um
Avicolum |  Avicol(um, i n
avide |  avide adv.
aviditas |  aviditas, atis f
avidus |  avidus, a, um
avis |  avis, is f
Avisanum |  Avisan(um, i n
Avitalum |  Avital(um, i n
avitus |  avitus, a, um
avium |  avium, i n
avius |  avius, a, um
Avlochinum |  Avlochin(um, i n
Avlochlorum |  Avlochlor(um, i n
Avlonum |  Avlon(um, i n
Avlosulfonum |  Avlosulfon(um, i n
avoco |  avoco, avi, atum, are
avolo |  avolo, avi, atum, are
avunculus |  avunculus, i m
avus |  avus, i m
Axenus |  Axenus, i m
Axerophtholum |  Axerophthol(um, i n
axialis |  axialis, e анат.
axilla |  axilla, ae f
axillaris |  axillaris, e анат.
axis |  I axis (assis), is m
Axius |  Axius, i m
axon |  axon, onis m
Axona |  Axona, ae m
axungia |  axungia, ae f
Azaphenum |  Azaphen(um, i n
Azathioprinum |  Azathioprin(um, i n
Azetidinum |  Azetidin(um, i n
Azoxodonum |  Azoxodon(um, i n
azygos |  azygos анат.
