caballus |  caballus, i m
Cabillonum |  Cabillonum, i n
Cabira |  Cabira, orum n
Cabiri |  Cabiri, orum m
cacao |  cacao indecl.
cachinno |  cachinno, avi, atum, are
cachinnus |  cachinnus, i m
caco |  caco, avi, atum, are
cacumen |  cacumen, inis n
cacumino |  cacumino, avi, atum, are
Cacus |  Cacus, i m
cadaver |  cadaver, eris n
Cadmea |  Cadmea, ae f
Cadmeis |  I Cadmeis, idos f
Cadmejus |  Cadmejus, a, um
Cadmeus |  Cadmeus, a, um
Cadmus |  Cadmus, i m
cado |  cado, cecidi, casum, ere
caduceator |  caduceator, oris m
caduceum |  caduceum, i n
caduceus |  caduceus, i m
caducifer |  caducifer, eri m
caducus |  caducus, а, um юр.
Cadurci |  Cadurci, orum m
cadus |  cadus, i m
Cadusii |  Cadusii, orum m
Caecilianus |  Caecilianus, a, um
Caecilius |  I Caecilius, a, um
caecitas |  caecitas, atis f
caeco |  caeco, avi, atum, are
Caecubus |  Caecubus, a, um
Caeculus |  Caeculus, i m
caecus |  caecus, a, um бот.
caedes |  caedes, is f
caedo |  caedo, cecidi, caesum, ere
caelamen |  caelamen, inis n
caelator |  caelator, oris m
caelebs |  caelebs, ibis
caeles |  I caeles, itis m
caelestis |  I caelestis, e m
Caelianus |  Caelianus, a, um
caelibatus |  caelibatus, us m
caelicola |  caelicola, ae m
caelifer |  caelifer, era, erum
Caelius |  Caelius (Coelius), a, um
caelo |  caelo, avi, atum, are ����.
caelum |  caelum (coelum), i n
caelus |  caelus, i m
caementum |  caementum, i n
caena |  caena
Caenina |  Caenina, ae f
Caeninenses |  Caeninenses, ium m
Caeninus |  Caeninus, a, um
caeno |  caeno, avi, atum, are
Caenophrurium |  Caenophrurium, i n
caenum |  caenum, i n
caepa |  caepa, ae f
caepe |  caepe, is n
Caepio |  Caepio, onis m
Caere |  Caere, n
Caeres |  I Caeres, itis f
Caeretani |  Caeretani, orum m
Caeretanus |  Caeretanus, a, um
Caeretes |  Caeretes, um m
caerimonia |  caerimonia, ae f
Caerites |  Caerites m
caerula |  caerula,orum n
caeruleus |  caeruleus
caerulus |  caerulus, a, um
Caesar |  Caesar, aris m
Caesarea |  Caesarea, ae f
Caesareus |  Caesareus, a, um
Caesariani |  Caesariani, orum m
Caesarianus |  Caesarianus, a, um
Caesariensis |  Caesariensis, e
caesaries |  caesaries, ei f
Caesarinus |  Caesarinus, a, um
Caesena |  Caesena, ae f
Caesia |  Caesia silva f
caesim |  caesim adv.
Caeso |  Caeso, onis m
Caesonius |  Caesonius, a, um
caespes |  caespes, itis m
caestus |  caestus, us m
caet |  caet...
caetra |  caetra, ae f
caetratus |  caetratus a, um
cafea |  cafea, ae f
cafeum |  cafeum, i n
Caffeinum |  Caffein(um, i n
Cafronum |  Cafron(um, i n
Caicus |  Caicus, i m
Cajeta |  Cajeta, ae f
Cajete |  Cajete, es f
Cajus |  Cajus, a, um
Calaber |  Calaber, bra, brum
Calabri |  Calabri, orum m
Calabria |  Calabria, ae f
Calacte |  Calacte, es f
Calactini |  Calactini, orum m
Calactinus |  Calactinus, a, um
Calagurris |  Calagurris, is f
Calagurritani |  Calagurritani, orum m
Calais |  Calais, idis m
Calamis |  Calamis, idis m
calamister |  calamister, tri m
calamistratus |  calamistratus, a, um
calamistrum |  calamistrum, tri n
calamitas |  calamitas, atis f
calamitosus |  calamitosus, a, um
calamus |  calamus, i m
calantica |  calantica, ae f
calathus |  calathus, i m
Calatia |  Calatia, ae f
Calatini |  Calatini, orum m
Calatinus |  Calatinus, a, um
Calaurea |  Calaurea (Calauria), ae f
calautica |  calautica (calantica), ae f
calcaneocuboideus |  calcaneocuboideus, a, um анат.
calcaneonavicularis |  calcaneonavicularis, e анат.
calcaneum |  calcaneum, i n
calcaneus |  calcaneus, a, um анат.
calcar |  calcar, aris n
calcarinus |  calcarinus, a, um
Calcedon |  Calcedon, onis f
calceo |  calceo, avi, atum, are
calceus |  calceus, i m
Calchas |  Calchas, antis m
Calchedon |  Calchedon (Calcedon, Chalcedon), onis f
Calchedonii |  Calchedonii, orum m
Calchedonius |  Calchedonius, a, um
calci |  calci...
Calciferolum |  Calciferol(um, i n
Calciiodinum |  Calciiodin(um, i n
calcitro |  calcitro, avi, atum, are
Calcium |  Calcium, i n
calcius |  calcius, i m
calco |  calco, avi, atum, are
Calcuitum |  Calcuit(um, i n
calculosis |  calculosis, is f
calculosus |  calculosus, a, um мед.
calculus |  calculus, i m
calda |  calda, ae f
caldus |  caldus, a, um
Caledonia |  Caledonia, ae f
calefacio |  calefacio или calfacio, feci, factum, ere
calefacto |  calefacto, --, --, are
calefio |  calefio pass.
Calendae |  Calendae (Kalendae), arum f
calendarium |  calendarium, i n
Calendula |  Calendula, ae f
Calenus |  Calenus, a, um
caleo |  caleo, ui, -- ere
Cales |  Cales, ium f
calesco |  calesco, calui, --, ere
Caletes |  Caletes, um m
Caleti |  Caleti, orum m
calfacio |  calfacio, feci, factum, ere
calfacto |  calfacto, --, --, are
Calgamum |  Calgam(um, i n
caliandrum |  caliandrum (caliendrum), i n
calices |  calices, um f
caliculus |  caliculus, i m
calida |  I calida (calda), ae f
calidus |  calidus (caldus), a, um
caliendrum |  caliendrum, i n
caliga |  caliga, ae f
caliginosus |  caliginosus, a, um
caligo |  I caligo, avi, atum, are f
calix |  calix, icis m
calleo |  calleo, ui, --, ere
Callicula |  Callicula, ae f
callide |  callide adv.
calliditas |  calliditas, atis f
Callidromos |  Callidromos (-us), i m
callidus |  callidus, a, um
Callifae |  Callifae, arum f
Callimachus |  Callimachus, i m
Calliope |  Calliope, es f
Calliphon |  Calliphon, ontis m
Callipolis |  Callipolis, is f
Callirrhoe |  Callirrhoe, es f
callis |  callis, is m
Callisthenes |  Callisthenes, is m
Callisto |  Callisto, us f
callosus |  callosus, a, um
callum |  callum, i n
Calmodidum |  Calmodid(um, i n
calo |  I calo, avi, atum, are m
calophyllus |  calophyllus, a, um бот.
calor |  I calor, oris m
Calosoma |  Calosoma, atis n
Calpanatum |  Calpanat(um, i n
Calpe |  Calpe, es f
Calpurnianus |  Calpurnianus, a, um
Calpurnius |  Calpurnius, a, um
caltha |  caltha, ae f
calumnia |  calumnia, ae f
calumniator |  calumniator, oris m
calumnior |  calumnior, atus sum, ari
calva |  calva, ae f
calvaria |  calvaria, ae f
Calvisius |  Calvisius, a, um
calvor |  calvor, --, calvi pass.
calvus |  calvus, a, um
calx |  I calx, calcis f
Calycadnus |  Calycadnus, i m
calyces |  calyces, um f
Calydon |  Calydon, onis f
Calydonis |  I Calydonis, idis f
Calydonius |  Calydonius, a, um
Calymne |  Calymne, es f
Calypso |  Calypso, us (onis) f
camara |  camara, ae f
Camarina |  Camarina, ae f
Cambunii |  Cambunii montes m
Cambyses |  Cambyses, is m
camella |  camella, ae f
camelus |  camelus, i m
Camena |  Camena (Camoena), ae f
camera |  camera (camara), ae f
Cameria |  Cameria, ae f
Camerina |  Camerina (Camarina), ae f
Camerinum |  Camerinum, i n
Camerinus |  Camerinus, a, um
Camerium |  Camerium, i n
Camers |  Camers, ertis
Camertes |  Camertes, ium m
Camertinus |  Camertinus, a, um
Cametonum |  Cameton(um, i n
Camillus |  Camillus, i m
caminus |  caminus, i m
Camirus |  Camirus, i f
Camoena |  Camoena, ae f
Camoludunum |  Camoludunum, i n
Campani |  Campani, orum m
Campania |  Campania, ae f
Campanus |  Campanus, a, um
campester |  campester, stris, stre
campestre |  campestre, is n
Camphatalum |  Camphatal(um, i n
Camphidonium |  Camphidonium, i n
Camphiodum |  Camphiod(um, i n
Camphocinum |  Camphocin(um, i n
Camphodalum |  Camphodal(um, i n
Camphonium |  Camphonium, i n
Camphora |  Camphora, ae f
Camphoratus |  Camphoratus, a, um фармац.
Campolonum |  Campolon(um, i n
campus |  campus, i m
camurus |  camurus, a, um
Canace |  Canace, es f
Canae |  Canae, arum f
canalis |  canalis, is m
Canastrum |  Canastrum, i n
cancelli |  cancelli, orum m
cancer |  cancer, eri m
cancerogenus |  cancerogenus, a, um мед.
cancerophobia |  cancerophobia, ae f
Candavia |  Candavia, ae f
candela |  candela, ae f
candelabrum |  candelabrum, bri n
candeo |  candeo, ui, --, ere
candesco |  candesco, dui, --, are
candidatus |  I candidatus, a, um m
candidus |  candidus, a, um
candor |  candor, oris m
caneo |  caneo, --, --, ere
canephoros |  canephoros, i pl.
canesco |  canesco, nui, --, ere
Cangi |  Cangi, orum m
cani |  cani, orum m
canicula |  canicula, ae f
caniculares |  caniculares, ium n
Canidius |  Canidius, a, um
Caninianus |  Caninianus, a, um
Caninius |  Caninius, a, um
caninus |  caninus, a, um анат.
Canis |  I Canis, is m
canistrum |  canistrum, i n
canities |  canities, ei f
canna |  canna, ae f
Cannae |  Cannae, arum f
Cannensis |  Cannensis, e
Canniefas |  Canniefas, atis
Canniefates |  Canniefates, ium m
cano |  cano, cecini, cantum, ere воен.
Canopeus |  Canopeus, a, um
Canopitae |  Canopitae, arum m
Canopus |  Canopus, i m
canor |  canor, oris m
canorus |  canorus, a, um
Cantabri |  Cantabri, orum m
Cantabria |  Cantabria, ae f
Cantabricus |  Cantabricus, a, um
Cantazinum |  Cantazin(um, i n
canterius |  canterius, i m
cantharis |  cantharis, idis f
cantharus |  cantharus, i m
cantherius |  cantherius (canterius), i m
canthus |  canthus, i m
canticum |  canticum, i n
Cantium |  Cantium, i n
canto |  canto, avi, atum, are
cantor |  cantor, oris m
Cantrexum |  Cantrex(um, i n
cantus |  cantus, us m
Canulejus |  Canulejus, a, um
canus |  canus, a, um поэт.
Canusini |  Canusini, orum m
Canusinus |  Canusinus, a, um
Canusium |  Canusium, i n
Capaneus |  I Capaneus, a, um m
capax |  capax, acis
capella |  I capella, ae f
Capena |  Capena, ae f
Capenas |  Capenas, atis
Capenates |  Capenates, ium m
Capenus |  Capenus, a, um
caper |  caper, pri m
capesso |  capesso, ivi (ii), itum, ere
Caphareus |  I Caphareus, a, um m
capillare |  capillare, is n
capillaris |  capillaris, e анат.
capillatus |  capillatus, a, um
capilli |  capilli, orum m
capillus |  capillus, i m
capio |  capio, cepi, captum, ere pass.
capis |  capis, idis f
capistro |  capistro, (avi), atum, are
capistrun |  capistrun, i n
capital |  capital, alis n
capitalis |  capitalis, e
capitatis |  capitatis, e анат.
capitatus |  capitatus, a, um анат.
Capitinus |  Capitinus, a, um
Capitium |  Capitium, i n
Capitolinus |  I Capitolinus, a, um
Capitolium |  Capitolium, i n
capitulatim |  capitulatim adv.
capitulum |  capitulum, i n
Cappadoces |  Cappadoces, um m
Cappadocia |  Cappadocia, ae f
capra |  capra, ae f
caprea |  caprea, ae f
Capreae |  Capreae, arum f
Capreensis |  Capreensis, e
capreolus |  capreolus, i m
Capricornus |  Capricornus, i m
caprificus |  caprificus, i f
caprigenus |  caprigenus, а, um
caprinus |  caprinus, a, um
capripes |  capripes, edis
Capsa |  I Capsa, ae f
capsella |  capsella, ae f
Capsenses |  Capsenses, ium m
capsicum |  capsicum, i n
Capsinum |  Capsin(um, i n
Capsitrinum |  Capsitrin(um, i n
capsula |  capsula, ae f
capsus |  capsus, i m
captator |  captator, oris m
captio |  captio, onis f
captiosus |  captiosus, a, um
captivitas |  captivitas, atis f
captivus |  captivus, a, um
capto |  capto, avi, atum, are
captus |  captus, us m
Capua |  Capua, ae f
capulus |  capulus, i m
caput |  caput, itis n
Capys |  Capys, yis m
Car |  Car, Caris m
Caralitani |  Caralitani, orum m
Caralitanus |  Caralitanus, a, um
Caralitis |  Caralitis, idis f
carbacholinum |  carbacholin(um, i n
Carbadalum |  Carbadal(um, i n
Carbamazinum |  Carbamazin(um, i n
Carbamidum |  Carbamid(um, i n
Carbaminoylcholinum |  Carbaminoylcholin(um, i n
Carbarnazepinum |  Carbarnazepin(um, i n
Carbarsonum |  Carbarson(um, i n
carbaseus |  carbaseus, a, um
carbasus |  carbasus, i f
Carbazonum |  Carbazon(um, i n
Carbidinum |  Carbidin(um, i n
Carbilazinum |  Carbilazin(um, i n
carbo |  carbo, onis m
Carbochromenum |  Carbochromen(um, i n
Carbogenum |  Carbogen(um, i n
Carbolenum |  Carbolen(um, i n
carbonas |  carbonas, atis m
Carboneum |  Carboneum, i n
Carbonicus |  Carbonicus, a, um хим.
Carbophosum |  Carbophos(um, i n
Carbromalum |  Carbromal(um, i n
Carbutamidum |  Carbutamid(um, i n
Carcaso |  Carcaso (Carcasso), onis f
Carcasso |  Carcasso, onis f
carcer |  carcer, eris m
carchesium |  carchesium, i n
carcinoma |  carcinoma, atis n
cardaces |  cardaces, um m
cardia |  I cardia, ae f
cardiacus |  cardiacus, а, um анат.
Carsulae |  Carsulae, arum f
Carteja |  Carteja, ae f
Cartejensis |  Cartejensis, e
Carthaea |  Carthaea, ae f
Carthaeus |  Carthaeus, a, um
Carthaginienses |  Carthaginienses, ium m
Carthaginiensis |  Carthaginiensis, e
Carthago |  Carthago, inis f
carthamoides |  carthamoides, is фармац.
Carthejus |  Carthejus, a, um
cartilagineus |  cartilagineus, a, um анат.
cartilaginosus |  cartilaginosus, a, um анат.
cartilago |  cartilago, inis f
caruncula |  caruncula, ae f
carus |  I carus, a, um m
Carvasinum |  Carvasin(um, i n
Caryae |  Caryae, arum f
caryogamia |  caryogamia, ae f
caryologia |  caryologia, ae f
Caryolysinum |  Caryolysin(um, i n
Carysteus |  Carysteus, a, um
Carystii |  Carystii, orum m
Carystius |  Carystius, a, um
Carystus |  Carystus, i f
casa |  casa, ae f
Casantinum |  Casantin(um, i n
Casca |  Casca, ae m
cascus |  cascus, a, um
caseosus |  caseosus, a, um
caseta |  caseta, ae f
caseus |  caseus, i m
casia |  casia, ae f
Casilinenses |  Casilinenses, ium m
Casilinum |  Casilinum, i n
Casinas |  Casinas, atis
Casinum |  Casinum, i n
Casperia |  Casperia, ae f
Caspius |  Caspius, a, um
Cassandra |  Cassandra, ae f
Cassandrea |  Cassandrea f
Cassandrenses |  Cassandrenses, ium m
Cassandreus |  Cassandreus (=Cassandre^us), ei m
cassia |  I cassia, ae f
Cassianus |  Cassianus, a, um
cassida |  cassida, ae f
Cassiope |  I Cassiope, es f
cassis |  I cassis, idis f
Cassius |  Cassius, a, um
cassus |  cassus, a, um
Castalia |  Castalia, ae f
Castalius |  Castalius, a, um
castanea |  castanea, ae f
caste |  caste adv.
castellani |  castellani, orum m
castellatim |  castellatim adv.
castellum |  castellum, i n
castigatio |  castigatio, onis f
castigator |  castigator, oris m
castigatus |  castigatus, a, um
castigo |  castigo, avi, atum, are
castimonia |  castimonia, ae f
castitas |  castitas, atis f
castor |  I castor, oris m
castoreum |  castoreum, i n
castra |  I castra, orum n
castrensis |  castrensis, e
castro |  castro, avi, atum, are
castrum |  I castrum, i n
Castulo |  Castulo, onis m
Castulonensis |  Castulonensis, e
castus |  castus, a, um
casu |  casu adv.
casula |  casula, ae f
casus |  casus, us m
Catabathmus |  Catabathmus, i m
Catadupa |  Catadupa, orum n
Catalauni |  Catalauni, orum m
Catamitus |  Catamitus, i m
Catane |  Catane, es f
Catanilum |  Catanil(um, i n
Cataonia |  Cataonia, ae f
cataphractus |  cataphractus, a, um
cataplus |  cataplus, i m
Catapresanum |  Catapresan(um, i n
catapulta |  catapulta, ae f
Catapyrinum |  Catapyrin(um, i n
cataracta |  cataracta (catarracta), ae f
cataraсtes |  cataraсtes, ae m
catarracta |  catarracta, ae f
cate |  cate adv.
cateja |  cateja, ae f
catella |  catella, ae f
catellus |  catellus, i m
catena |  catena, ae f
catenatus |  catenatus, a, um
caterva |  caterva, ae f
catervatim |  catervatim adv.
catharticus |  catharticus, a, um, i n
cathedra |  cathedra, ae f
Cathocinum |  Cathocin(um, i n
Cathomycinum |  Cathomycin(um, i n
Catianus |  Catianus, a, um
Catilina |  Catilina, ae m
Catilinarius |  Catilinarius, a, um
Catillus |  Catillus (Catilus), i m
catillus |  catillus, i m
Catina |  Catina, ae f
Catinensis |  Catinensis, e
catinus |  catinus, i m
Catius |  Catius, i m
Cato |  Cato, onis m
Catonianus |  Catonianus, a, um
Catonini |  Catonini, orum m
Catti |  Catti
Catullus |  Catullus, i m
catulus |  catulus, i m
Caturiges |  Caturiges, um m
catus |  catus, a, um
Caucasius |  Caucasius, a, um
Caucasus |  Caucasus, i m
cauda |  cauda, ae f
caudalis |  caudalis, e анат.
caudatus |  caudatus, a, um
caudex |  caudex, icis m
Caudini |  Caudini, orum m
Caudinus |  Caudinus, a, um
Caudium |  Caudium, i n
caulae |  caulae (caullae), arum f
caulis |  caulis, is m
caullae |  caullae, arum f
caulogenus |  caulogenus, a, um бот.
Caulon |  Caulon, onis m
Caulonia |  Caulonia, ae f
Cauneae |  Cauneae, arum f
Caunei |  Caunei, orum m
Cauneus |  Cauneus, a, um
Caunii |  Caunii, orum m
Caunius |  Caunius, a, um
Caunus |  Caunus, i f
caupo |  caupo (copo), onis m
caupona |  caupona, ae f
cauponula |  cauponula, ae f
Caurus |  Caurus (Corus), i m
causa |  causa (caussa), ae f
causarii |  causarii, orum m
causarius |  causarius, a, um
causidicus |  causidicus, i m
causor |  causor, atus sum, ari
caussa |  caussa, ae f
caute |  caute adv.
cautes |  cautes, is f
cautio |  cautio, onis f
cautor |  cautor, oris m
cautus |  cautus, a, um
cavea |  cavea, ae f
caveo |  caveo, cavi, cautum, ere юр.
caverna |  caverna, ae f
cavernalis |  cavernalis, e анат.
cavernosus |  cavernosus, a, um анат.
Cavicornia |  Cavicornia, ium n
cavillatio |  cavillatio, onis f
cavillor |  cavillor, atus sum, ari
cavitas |  cavitas, atis f
cavo |  cavo, avi, atum, are
cavocavalis |  cavocavalis, e анат.
Cavonylum |  Cavonyl(um, i n
cavum |  cavum, i n
cavus |  cavus, a, um
Caystrius |  Caystrius, a, um
Caystrus |  Caystrus (-os), i m
Cea |  Cea (Cia), ae f
Ceangi |  Ceangi, orum m
Cebenna |  Cebenna mons m
Cebionum |  Cebion(um, i n
Cebren |  Cebren, enis m
Cebrenis |  Cebrenis, idos f
cecalis |  cecalis, e анат.
Cecropes |  Cecropes, um m
Cecropia |  Cecropia, ae f
Cecropidae |  Cecropidae, arum m
Cecropides |  Cecropides, ae m
Cecropis |  Cecropis, idis f
Cecropius |  Cecropius, a, um
Cecrops |  Cecrops, opis m
cecum |  cecum, i n
cecus |  cecus, a, um анат.
Cedilanidum |  Cedilanid(um, i n
Cedisanolum |  Cedisanol(um, i n
Cedistabilum |  Cedistabil(um, i n
cedo |  I cedo
Cedoxinum |  Cedoxin(um, i n
cedrus |  cedrus, i f
Cefaloridinum |  Cefaloridin(um, i n
Ceflorinum |  Ceflorin(um, i n
Ceglunatum |  Ceglunat(um, i n
Cei |  Cei, orum m
Celadigalum |  Celadigal(um, i n
Celaenae |  Celaenae, arum f
Celaenaeus |  Celaenaeus, a, um
Celaeno |  Celaeno, us f
Celanidum |  Celanid(um, i n
Celbeninum |  Celbenin(um, i n
celeber |  celeber, bris, bre
celebratio |  celebratio, onis f
celebratus |  celebratus, a, um
celebritas |  celebritas, atis f
celebro |  celebro, avi, atum, are
Celemna |  Celemna, ae f
celer |  celer, eris, ere
Celeres |  Celeres, um m
celeritas |  celeritas, atis f
celeriter |  celeriter adv.
celero |  celero, avi, atum, are
Celetrum |  Celetrum, i n
Celeus |  Celeus, i m
celia |  celia, ae f
celiacus |  celiacus, a, um анат.
Celinum |  Celin(um, i n
Celiomycinum |  Celiomycin(um, i n
cella |  cella, ae f
cellula |  cellula, ae f
cellularis |  cellularis, e биолог.
cellulosus |  cellulosus, a, um биолог.
celo |  celo, avi, atum, are
Celocainum |  Celocain(um, i n
Celocurinum |  Celocurin(um, i n
celoma |  celoma, atis n
celox |  celox, ocis f
celsus |  celsus, a, um
Celtae |  Celtae, arum m
Celtiberi |  Celtiberi, orum m
Celtiberia |  Celtiberia, ae f
Celtibericus |  Celtibericus, a, um
Celticum |  Celticum, i n
Celticus |  Celticus, a, um
cementum |  cementum, i n
cena |  cena (caena или coena), ae f
Cenabum |  Cenabum, i n
cenaculum |  cenaculum, i n
Cenaeum |  Cenaeum, i n
Cenaeus |  Cenaeus, a, um
cenatus |  cenatus, а, um
Cenchreae |  Cenchreae, arum f
Cenchreus |  Cenchreus, a, um
Cenchrius |  Cenchrius, i m
Cenetonum |  Ceneton(um, i n
ceno |  ceno (caeno или coeno), avi, atum, are
Cenomani |  Cenomani, orum m
censeo |  censeo, censui, censum, ere
censor |  censor, oris m
censorius |  censorius, a, um
censura |  censura, ae f
census |  census, us m
centanculus |  centanculus, i m
centaureum |  centaureum (-ium), i n
Centaureus |  Centaureus, a, um
Centaurium |  Centaurium, i n
Centaurus |  Centaurus, i m
Centedrinum |  Centedrin(um, i n
centeni |  centeni, ae, a gen.
centenus |  centenus, a, um
centesima |  centesima, ae f
centesimus |  centesimus, a, um
centiceps |  centiceps, сipitis
centiens |  centiens (centies) adv.
centies |  centies
centigramma |  centigramma, atis n
centimanus |  centimanus, a, um
cento |  cento, onis m
centractilum |  centractil(um, i n
centralis |  centralis, e
Centraminum |  Centramin(um, i n
Centrazolum |  Centrazol(um, i n
centrifuga |  centrifuga, ae f
centromedianus |  centromedianus, a, um анат.
Centrones |  Centrones, um m
Centrophenoxinum |  Centrophenoxin(um, i n
centrum |  centrum, i n
centum |  centum indecl.
centumgeminus |  centumgeminus, a, um
centumvir |  centumvir, i m
centumviralis |  centumviralis, e
centuria |  centuria, ae f
centuriatim |  centuriatim adv.
centuriatus |  I centuriatus, us m
centurio |  I centurio, avi, atum, are m
Centuripae |  Centuripae, arum f
Centuripini |  Centuripini, orum m
Centuripinus |  Centuripinus, a, um
cenula |  cenula, ae f
cenum |  cenum, i m
Ceos |  Ceos f
cepa |  cepa (caepa), ae f
cepe |  cepe, is n
cephalgia |  cephalgia, ae f
cephalicus |  cephalicus, a, um анат.
Cephallania |  Cephallania, ae f
Cephallenes |  Cephallenes, um m
Cephallenia |  Cephallenia (Cephallania), ae f
Cephaloedis |  Cephaloedis, idis f
Cephaloeditani |  Cephaloeditani, orum m
Cephaloeditanus |  Cephaloeditanus, a, um
Cephaloedium |  Cephaloedium, i n
Cephalopoda |  Cephalopoda, orum n
Cephaloridinum |  Cephaloridin(um, i n
Cepheis |  Cepheis, idis f
Cephejus |  Cephejus, a, um
Cepheus |  Cepheus (=Cephe^us), ei m
Cephisias |  Cephisias, adis f
Cephisis |  Cephisis, idis f
Cephisius |  Cephisius, i m
Cephissias |  Cephissias, adis f
Cephissis |  Cephissis, idis f
Cephissius |  Cephissius, i m
Cephissus |  Cephissus (-os), i m
Cephisus |  Cephisus, i m
Ceporinum |  Ceporin(um, i n
cera |  cera, ae f
Ceramicus |  Ceramicus (-os), i m
cerarium |  cerarium, i n
Cerastae |  Cerastae, arum m
cerasus |  cerasus, i f
ceratocricoideus |  ceratocricoideus, a, um анат.
ceratopharyngeus |  ceratopharyngeus, a, um анат.
ceratus |  ceratus, a, um
Ceraunia |  Ceraunia, orum n
Ceraunii |  Ceraunii montes m
Cerbereus |  Cerbereus, a, um
Cerberus |  Cerberus (-os), i m
Cercina |  Cercina, ae f
Cercocebus |  Cercocebus, i m
cercurus |  cercurus, i m
Cercyo |  Cercyo, onis m
Cerealia |  Cerealia (Cerialia), ium n
Cerealis |  Cerealis (Cerialis), e
cerebellaris |  cerebellaris, e анат.
cerebellomedullaris |  cerebellomedullaris, e анат.
cerebellorubralis |  cerebellorubralis, e анат.
cerebellothalamicus |  cerebellothalamicus, a, um анат.
cerebellum |  cerebellum, i n
cerebralis |  cerebralis, e анат.
Cerebrolysinum |  Cerebrolysin(um, i n
cerebrosus |  cerebrosus, i m
cerebrum |  cerebrum, i n
ceremonia |  ceremonia, ae f
Ceres |  Ceres, eris f
cereus |  I cereus, a, um m
cerevisiae |  cerevisiae, arum f
Cerialia |  Cerialia, ium n
Cerialis |  Cerialis, e
Cerigelum |  Cerigel(um, i n
cerimonia |  cerimonia, ae f
cerintha |  cerintha, ae f
cerinthe |  cerinthe, es f
cerno |  cerno, crevi, cretum, ere
cernuus |  cernuus, a, um
cero |  cero, avi, atum, are
Cerocainum |  Cerocain(um, i n
cerritus |  cerritus, a, um
certamen |  certamen, inis n
certatim |  certatim adv.
certatio |  certatio, onis f
certe |  certe adv.
certo |  I certo adv.
certus |  certus, a, um
ceruleus |  ceruleus, а um
cerumen |  cerumen, inis n
ceruminosus |  ceruminosus, a, um анат.
cerva |  cerva, ae f
cervicalis |  cervicalis, e анат.
cervicothoracicus |  cervicothoracicus, a, um анат.
cervicula |  cervicula, ae f
cervinus |  cervinus, a, um
cervix |  cervix, icis f
cervus |  cervus, i m
cespes |  cespes (caespes), itis m
cessatio |  cessatio, onis f
cessator |  cessator, oris m
cesso |  cesso, avi, atum, are
Cestocidum |  Cestocid(um, i n
cestrosphendone |  cestrosphendone, es f
cetarium |  cetarium, i n
cetarius |  cetarius, i m
cetera |  cetera adv.
ceterum |  ceterum adv.
ceterus |  ceterus, a, um pl.
Cethegus |  Cethegus, i m
cetodosis |  cetodosis, is f
Cetorhinus |  Cetorhinus, i m
cetos |  cetos, i m
cetra |  cetra (caetra), ae f
cetrati |  cetrati, orum m
cetratus |  cetratus (caetratus) a, um преим.
cetus |  cetus (cetos), i m
ceu |  ceu adv.
Ceus |  Ceus, a, um
Ceutrones |  Ceutrones, um m
Cevalinum |  Cevalin(um, i n
Cevanolum |  Cevanol(um, i n
Cevexum |  Cevex(um, i n
Ceyx |  Ceyx, ycis m
Chaeronea |  Chaeronea, ae f
Chaetognata |  Chaetognata, orum n
Chalcedon |  Chalcedon, onis f
Chalcidenses |  Chalcidenses, ium m
Chalcidensis |  Chalcidensis, e
Chalcidicus |  Chalcidicus, a, um
Chalcioecus |  Chalcioecus, i f
Chalciope |  Chalciope, es f
Chalcis |  Chalcis, idis (idos) f
Chaldaea |  Chaldaea, ae f
Chaldaei |  Chaldaei, orum m
Chaldaeus |  Chaldaeus, a, um
Chaldaicus |  Chaldaicus, a, um
chalybeius |  chalybeius, a, um
Chalybes |  Chalybes, um m
chalybs |  chalybs, ybis m
chamomilla |  chamomilla, ae f
Chaones |  Chaones, um m
Chaonia |  Chaonia, ae f
Chaonis |  Chaonis, idis
Chaonius |  Chaonius, a, um
chaos |  chaos ( acc.
chara |  chara, ae f
Charax |  Charax, acis f
Charis |  Charis, itos f
charistia |  charistia (caristia), orum n
Charmadas |  Charmadas, ae m
Charon |  Charon, ontis (onis) m
Charondas |  Charondas, ae m
charta |  charta, ae f
Charybdis |  Charybdis, is f
Chatti |  Chatti (Catti), orum m
Chauci |  Chauci (Cauchi или Cauci, Cayci), orum m
cheilanthus |  cheilanthus, a, um биолог.
cheilitis |  cheilitis, idis f
cheiloplastica |  cheiloplastica, ae f
cheilorrhagia |  cheilorrhagia, ae f
cheiloschisis |  cheiloschisis, is f
cheilosis |  cheilosis, is f
cheirophyllus |  cheirophyllus, a, um бот.
chelae |  chelae, arum f
Chelatonum |  Chelaton(um, i n
Chelenum |  Chelen(um, i n
Chelidon |  Chelidon, onis f
Chelidoniae |  Chelidoniae insulae f
Chellina |  Chellina, ae f
chelydrus |  chelydrus, i m
chelys |  chelys ( acc.
Chemiazidum |  Chemiazid(um, i n
Chemiochinum |  Chemiochin(um, i n
Chemiofuranum |  Chemiofuran(um, i n
Chemocainum |  Chemocain(um, i n
Chemovirum |  Chemovir(um, i n
cheregra |  cheregra, ae f
Chersonesus |  Chersonesus, i f
Cherusci |  Cherusci, orum m
chiasma |  chiasma, atis n
Chii |  Chii, orum m
chiliarches |  chiliarches, ae m
chiliarchus |  chiliarchus, i m
Chilopoda |  Chilopoda, orum n
Chimaera |  Chimaera, ae f
Chimaerifer |  Chimaerifer, era, erum
chimiotherapia |  chimiotherapia, ae f
Chinacrinum |  Chinacrin(um, i n
Chinensis |  Chinensis, e
Chingaminum |  Chingamin(um, i n
Chinidinum |  Chinidin(um, i n
Chininum |  Chinin(um, i n
Chiniofonum |  Chiniofon(um, i n
Chinoceptinum |  Chinoceptin(um, i n
Chinocidum |  Chinocid(um, i n
Chinoformum |  Chinoform(um, i n
Chinosolum |  Chinosol(um, i n
Chinosulfanum |  Chinosulfan(um, i n
Chione |  Chione, es f
Chios |  Chios (-us), i f
chiragra |  chiragra (cheragra), ae f
Chiro |  Chiro, onis m
chirographum |  chirographum, i n
chirographus |  chirographus, i m
Chiron |  Chiron (Chiro), onis m
Chiroptera |  Chiroptera, orum n
chirurgia |  chirurgia, ae f
chirurgicus |  chirurgicus, a, um мед.
Chium |  Chium, i n
Chius |  Chius, a, um
chlamydatus |  chlamydatus, a, um
chlamys |  chlamys, ydis f
Chloceptinum |  Chloceptin(um, i n
Chlocyclamidum |  Chlocyclamid(um, i n
Chlophazolinum |  Chlophazolin(um, i n
Chloracetophosum |  Chloracetophos(um, i n
Chloraconum |  Chloracon(um, i n
Chloracyzinum |  Chloracyzin(um, i n
Chloramphenicolum |  Chloramphenicol(um, i n
chloratus |  chloratus, a, um хим.
Chlorazenum |  Chlorazen(um, i n
Chlorazinum |  Chlorazin(um, i n
Chlorbutinum |  Chlorbutin(um, i n
Chlorbutolum |  Chlorbutol(um, i n
Chlorchinaldolum |  Chlorchinaldol(um, i n
Chlorenum |  Chloren(um, i n
Chloretanum |  Chloretan(um, i n
Chlorethazinum |  Chlorethazin(um, i n
Chloretonum |  Chloreton(um, i n
Chlorguanidum |  Chlorguanid(um, i n
Chloridinum |  Chloridin(um, i n
Chlorigenum |  Chlorigen(um, i n
Chloriguanum |  Chloriguan(um, i n
Chloriodoquinum |  Chloriodoquin(um, i n
Chloris |  Chloris, idis f
Chlormeprazinum |  Chlormeprazin(um, i n
Chlormerodrinum |  Chlormerodrin(um, i n
Chlormethinum |  Chlormethin(um, i n
Chlorneoanterganum |  Chlorneoantergan(um, i n
Chlornitromycinum |  Chlornitromycin(um, i n
Chlorobutanolum |  Chlorobutanol(um, i n
Chlorochinum |  Chlorochin(um, i n
Chlorocidum |  Chlorocid(um, i n
Chlorocyclina |  Chlorocyclina, ae f
Chloroformium |  Chloroformium, i n
Chlorogenium |  Chlorogenium, i n
Chlorohydra |  Chlorohydra, ae f
Chloromycetinum |  Chloromycetin(um, i n
Chloronitrinum |  Chloronitrin(um, i n
Chlorophenisatum |  Chlorophenisat(um, i n
Chlorophylliptum |  Chlorophyllipt(um, i n
chlorophyllum |  chlorophyllum, i n
Chlorophyta |  Chlorophyta, orum n
Chloroptithalmum |  Chloroptithalm(um, i n
Chloropyraminum |  Chloropyramin(um, i n
Chloroquinum |  Chloroquin(um, i n
Chlorotrianisenum |  Chlorotrianisen(um, i n
Chlorperazinum |  Chlorperazin(um, i n
Chlorpiprazinum |  Chlorpiprazin(um, i n
Chlorpiprozinum |  Chlorpiprozin(um, i n
Chlorprothixenum |  Chlorprothixen(um, i n
Chlorqufnaldolum |  Chlorqufnaldol(um, i n
Chlortetracyclinum |  Chlortetracyclin(um, i n
Chlortrianisenum |  Chlortrianisen(um, i n
Chlortrianisoestrolum |  Chlortrianisoestrol(um, i n
Chlorum |  Chlorum, i n
Chlorylenum |  Chlorylen(um, i n
Chlothlxenum |  Chlothlxen(um, i n
Chloxylum |  Chloxyl(um, i n
choanae |  choanae, arum f
Choaspes |  Choaspes, is m
Choladinum |  Choladin(um, i n
cholaemia |  cholaemia, ae f
Cholagolum |  Cholagol(um, i n
Cholambrinum |  Cholambrin(um, i n
Cholamidum |  Cholamid(um, i n
chole |  chole, es f
Cholecinum |  Cholecin(um, i n
cholecystectomia |  cholecystectomia, ae f
cholecystitis |  cholecystitis, idis f
cholecystogramma |  cholecystogramma, atis n
cholecystographia |  cholecystographia, ae f
cholecystopathia |  cholecystopathia, ae f
cholecystostoma |  cholecystostoma, atis n
cholecystostomia |  I cholecystostomia, ae f
choledochus |  choledochus, a, um
cholelithiasis |  cholelithiasis, is f
Cholenzymum |  Cholenzym(um, i n
cholestasis |  cholestasis, is f
Choletrastum |  Choletrast(um, i n
Cholevidum |  Cholevid(um, i n
Chologonum |  Chologon(um, i n
Cholografinum |  Cholografin(um, i n
Cholosasum |  Cholosas(um, i n
Cholospectum |  Cholospect(um, i n
Choloterpum |  Choloterp(um, i n
chondralis |  chondralis, e анат.
Chondrichthyes |  Chondrichthyes, um f
chondroblastus |  chondroblastus, i m
chondrogenesis |  chondrogenesis, is f
chondroglossus |  chondroglossus, a, um анат.
chondroma |  chondroma, atis n
chondropharyngeus |  chondropharyngeus, a, um анат.
chondros |  chondros, i m
chondrosis |  chondrosis, is f
Chonsuridum |  Chonsurid(um, i n
chorda |  chorda, ae f
chorea |  chorea (реже chorea), ae f
choriocapillaris |  choriocapillaris, e анат.
Choriogoninum |  Choriogonin(um, i n
chorioidea |  chorioidea, ae f
chorioideus |  chorioideus, a, um анат.
chorion |  chorion, i n
choripetalus |  choripetalus, a, um биолог.
chors |  chors, tis f
chorus |  chorus, i m
Christiani |  Christiani, orum m
Christianus |  I Christianus, a, um m
Christus |  Christus, i m
chroma |  chroma, atis n
Chromadrenalum |  Chromadrenal(um, i n
Chromadrenum |  Chromadren(um, i n
chromatophorum |  chromatophorum, i n
Chromoflavinum |  Chromoflavin(um, i n
chromogenum |  chromogenum, i n
chromogenus |  chromogenus, a, um биолог.
Chromonarum |  Chromonar(um, i n
chromosoma |  chromosoma, atis n
chronicus |  chronicus, a, um
chronobiologia |  chronobiologia, ae f
chrysanthes |  chrysanthes, is n
Chrysarobinum |  Chrysarobin(um, i n
Chrysas |  Chrysas, ae m
Chryse |  Chryse, es f
Chryseis |  Chryseis, idos f
Chryses |  Chryses, ae m
Chrysippeus |  Chrysippeus, a, um
Chrysippos |  Chrysippos, i m
Chrysis |  Chrysis, idis f
chrysocarpus |  chrysocarpus, a, um бот.
Chrysomallinum |  Chrysomallin(um, i n
chrysophrys |  chrysophrys ( acc.
chylostasis |  chylostasis, is f
chylothorax |  chylothorax, acis m
chyluria |  chyluria, ae f
chylus |  chylus, i m
Chymopsinum |  Chymopsin(um, i n
Cia |  Cia, ae f
Ciani |  Ciani, orum m
Cibalae |  Cibalae, arum f
cibaria |  cibaria orum n
cibarius |  cibarius, a, um
cibo |  cibo, avi, atum, are
ciborium |  ciborium, i n
cibus |  cibus, i m
Cibyra |  Cibyra, ae f
Cibyrates |  Cibyrates, ae m
Cibyraticus |  Cibyraticus, a, um
cicada |  cicada, ae f
cicatrix |  cicatrix, icis f
cicer |  cicer, eris n
Cicero |  Cicero, onis m
cichoreum |  cichoreum, i n
Cicones |  Cicones, um m
ciconia |  ciconia, ae f
Ciconidae |  Ciconidae, arum f
cicur |  cicur, uris
cicuta |  cicuta, ae f
cieo |  cieo, civi, citum, ciere воен.
ciliaris |  ciliaris, e анат.
Cilices |  Cilices, um m
Cilicia |  Cilicia, ae f
Ciliciensis |  Ciliciensis, e
cilicium |  cilicium, i n
Cilissa |  Cilissa, ae f
cilium |  cilium, i m
Cilix |  Cilix, icis
Cilla |  Cilla (Cylla), ae f
Cilnius |  Cilnius, a, um
Cimber |  Cimber, bra, brum
Cimbri |  Cimbri, orum m
Cimbricus |  Cimbricus, a, um
cimex |  cimex, icis m
Ciminalum |  Ciminal(um, i n
Ciminus |  Ciminus, i m
Cimmerii |  Cimmerii, orum m
Cimmerius |  Cimmerius, a, um
Cimolus |  Cimolus, i f
Cimon |  Cimon (Cimo), onis m
Cincainum |  Cincain(um, i n
Cinchocainum |  Cinchocain(um, i n
Cinchophanum |  Cinchophan(um, i n
Cinchophenum |  Cinchophen(um, i n
cincinnatus |  cincinnatus, a, um
cincinnus |  cincinnus, i m
Cincius |  Cincius, a, um
cinctus |  I cinctus, a, um m
cinctutus |  cinctutus, a, um
Cineas |  Cineas, ae m
cinephotomachina |  cinephotomachina, ae f
cinerarium |  cinerarium, i n
cinereus |  cinereus, a, um
Cinga |  Cinga, ae f
Cingetorix |  Cingetorix, igis m
cingo |  cingo, cinxi, cinctum, ere
cingula |  cingula, ae f
cingulum |  I cingulum, i n
cingulus |  cingulus, i m
ciniflo |  ciniflo, onis m
cinis |  cinis, eris m
Cinna |  Cinna, ae m
cinnamum |  cinnamum, i n
Cinnanus |  Cinnanus, a, um
Cinophenum |  Cinophen(um, i n
Cinyphius |  Cinyphius, a, um поэт.
Cinyps |  Cinyps, ypis (yphis) m
Cinyras |  Cinyras, ae m
Cinyrejus |  Cinyrejus, a, um
Cios |  Cios (-us), i f
cippus |  cippus, i m
circa |  I circa adv.
Circaeus |  Circaeus, a, um
circamligo |  circamligo, avi, atum, are
circamlinio |  circamlinio, linii, --, ire
circamoerium |  circamoerium, i n
circamvector |  circamvector, --, ari
Circe |  Circe, es f
Circejenses |  Circejenses, ium m
Circejensis |  Circejensis, e
Circeji |  Circeji, orum m
circensis |  circensis, e
circinus |  circinus, i m
circiter |  circiter adv.
circueo |  circueo
circuitio |  circuitio (circumitio), onis f
circuitus |  circuitus (circumitus), us m
circularis |  circularis, e анат.
circulatio |  circulatio, onis f
circulor |  circulor, --, ari
circulus |  circulus, i m
circum |  I circum adv.
circumago |  circumago, egi, actum, ere pass.
circumanalis |  circumanalis, e анат.
circumaro |  circumaro, avi, --, are
circumcido |  circumcido, cidi, cisam, ere
circumcisus |  circumcisus, a, um
circumcludo |  circumcludo, clusi, clusum, ere
circumcolo |  circumcolo, --, --, ere
circumdo |  circumdo, dedi, datum, are pass.
circumduco |  circumduco, duxi, ductum, ere
circumductio |  circumductio, onis f
circumeo |  circumeo (circueo), ivi (ii), itum, ire воен.
circumequito |  circumequito, --, --, are
circumferentia |  circumferentia, ae f
circumfero |  circumfero, tuli, latum, ferre pass.
circumflecto |  circumflecto, flexi, flexum, ere
circumflexus |  circumflexus, a, um анат.
circumflo |  circumflo, --, --, are
circumfluus |  circumfluus, а, um
circumforaneus |  circumforaneus, a, um
circumfundo |  circumfundo, fudi, fusum, ere
circumfusus |  circumfusus, a, um
circumgeno |  circumgeno, --, --, ere
circumgredior |  circumgredior, gressus sum, gredi
circuminjicio |  circuminjicio (circuminicio), --, --, ere
circumitio |  circumitio, onis f
circumitus |  circumitus, us m
circumjaceo |  circumjaceo, --, --, ere
circumjectus |  circumjectus, a, um
circumjicio |  circumjicio, jeci, jectum, ere
circumlavo |  circumlavo, --, --, are
circumlino |  circumlino, --, itum, ere
circumluo |  circumluo, --, --, ere
circummitto |  circummitto, misi, missum, ere
circummugio |  circummugio, --, --, ire
circummunio |  circummunio, avi, itum, ire
circummunitio |  circummunitio, onis f
circumpadanus |  circumpadanus, a, um
circumpendeo |  circumpendeo, --, --, ere
circumplaudo |  circumplaudo, --, --, ere
circumplector |  circumplector, plexus sum, plecti
circumpono |  circumpono, posui, positum, ere
circumretio |  circumretio, ivi, itum, ire
circumrodo |  circumrodo, rosi, --, ere
circumsaepio |  circumsaepio, saepsi, saeptum, ire
circumscindo |  circumscindo, --, --, ere
circumscribo |  circumscribo, scripsi, scriptum, ere
circumscriptio |  circumscriptio, onis f
circumscriptor |  circumscriptor, oris m
circumseco |  circumseco, (secui), sectum, are
circumsedeo |  circumsedeo, sedi, sessum, ere
circumsepio |  circumsepio
circumsessio |  circumsessio, onis f
circumsido |  circumsido, --, --, ere
circumsisto |  circumsisto, steti, --, ere
circumsono |  circumsono, sonui, --, are
circumsonus |  circumsonus, a, um
circumspectio |  circumspectio, onis f
circumspecto |  circumspecto, avi, atum, are
circumspectus |  I circumspectus, a, um m
circumspicio |  circumspicio, spexi, spectum, ere
circumsto |  circumsto, steti, --, are
circumtextus |  circumtextus, a, um
circumtono |  circumtono, tonui,--, are
circumvado |  circumvado, vasi, --, ere
circumvagus |  circumvagus, a, um
circumvallo |  circumvallo, avi, atum, are
circumvehor |  circumvehor, vectus sum, vehi
circumvelo |  circumvelo, --, --, are
circumvenio |  circumvenio, veni, ventum, ire
circumverto |  circumverto, verti, versum, ere
circumvolito |  circumvolito, avi, atum, are
circumvolo |  circumvolo, avi, atum, are
circumvolvo |  circumvolvo, volvi, volutum, ere pass.
circus |  circus, i m
ciris |  ciris, is f
Cirrha |  Cirrha, ae f
cirrhosis |  cirrhosis, is f
Cirta |  Cirta, ae f
Cirtenses |  Cirtenses, ium m
cirсino |  cirсino, avi, atum, are
cis |  cis praep.
cisalpinus |  cisalpinus, a, um
cisium |  cisium, i n
Cispius |  Cispius mons m
cisrhenanus |  cisrhenanus, a, um
Cisseis |  Cisseis, idis f
Cisseus |  Cisseus (=Cisse^us), ei m
cista |  cista, ae f
cisterna |  cisterna, ae f
cistophorus |  cistophorus (-os), i m
citatus |  citatus, a, um
Citellus |  Citellus, i m
citer |  citer, tra, trum compar.
citerius |  citerius adv.
Cithaeron |  Cithaeron, onis m
cithara |  cithara, ae f
citharista |  citharista, ae m
citharizo |  citharizo, --, --, are
citharoedus |  citharoedus, i m
Citiei |  Citiei, orum m
Citiensis |  Citiensis, e
Citieus |  I Citieus, a, um m
Citium |  Citium, i n
cito |  I cito adv.
Citocainum |  Citocain(um, i n
Citocholinum |  Citocholin(um, i n
Citodonum |  Citodon(um, i n
Citodormum |  Citodorm(um, i n
Citopanum |  Citopan(um, i n
Citosulfanum |  Citosulfan(um, i n
citra |  I citra adv.
Citralum |  Citral(um, i n
Citramonum |  Citramon(um, i n
citras |  citras, atis m
citreus |  citreus, a, um
citricus |  citricus, a, um хим.
citro |  citro adv.
citrus |  citrus, i f
citus |  citus, a, um
civicus |  civicus, a, um
civilis |  civilis, e
civiliter |  civiliter adv.
civis |  civis, is m
civitas |  civitas, atis f
clades |  clades, is f
Cladocera |  Cladocera, orum n
clam |  I clam adv.
clamito |  clamito, avi, atum, are
clamo |  clamo, avi, atum, are
clamor |  clamor ( арх.
clamos |  clamos, oris m
clanculum |  clanculum adv.
clandestinus |  clandestinus, a, um
clangor |  clangor, oris m
clangula |  clangula, ae f
Clanis |  Clanis, is m
Clanius |  Clanius, i m
clare |  clare adv.
clareo |  clareo, --, --, ere
claresco |  claresco, ui, --, ere
clarigatio |  clarigatio, onis f
Claripexum |  Claripex(um, i n
clarisonus |  clarisonus, a, um
claritas |  claritas, atis f
claritudo |  claritudo, inis f
Clarius |  Clarius, a, um
claro |  claro, avi, atum, are
Claros |  Claros (-us), i f
clarus |  clarus, a, um
classiarii |  classiarii, orum m
classiarius |  classiarius, a, um
classicum |  classicum, i n
classicus |  classicus, a, um
classis |  classis, is f
Clastidium |  Clastidium, i n
Claterna |  Claterna, ae f
clatri |  clatri, orum m
Claudianus |  Claudianus, a, um
claudico |  claudico, avi, atum, are
Claudius |  Claudius, a, um
claudo |  I claudo, --, --, ere
claudus |  claudus, a, um поэт.
clausa |  clausa, ae f
claustra |  claustra (clostra), orum n
claustrum |  claustrum, i n
clausula |  clausula, ae f
clava |  clava, ae f
clavicula |  clavicula, ae f
clavicularis |  clavicularis, e анат.
claviger |  I claviger, era, erum
clavis |  clavis, is f
clavus |  clavus, i m
Clazomenae |  Clazomenae, arum f
Clazomenius |  Clazomenius, a, um
Cleanthes |  Cleanthes, is m
clemens |  clemens, entis
clementer |  clementer adv.
clementia |  clementia, ae f
Cleo |  Cleo, onis m
Cleobis |  Cleobis, is m
Cleolum |  Cleol(um, i n
Cleombrotus |  Cleombrotus, i m
Cleon |  Cleon (Cleo), onis m
Cleonacus |  Cleonacus, a, um
Cleonae |  Cleonae, arum f
Cleopatra |  Cleopatra, ae f
cliens |  cliens, entis m
clienta |  clienta, ae f
clientela |  clientela, ae f
Climacterinum |  Climacterin(um, i n
Climovanum |  Climovan(um, i n
clinatus |  clinatus, a, um
Clinestrolum |  Clinestrol(um, i n
clinoideus |  clinoideus, a, um
Clio |  Clio, us f
Clionum |  Clion(um, i n
clipeati |  clipeati, orum m
clipeatus |  clipeatus, a, um
clipeum |  clipeum, i n
clipeus |  clipeus ( арх.
Clisthenes |  Clisthenes, is m
Clitarchus |  Clitarchus, i m
clitellae |  clitellae, arum f
Cliterninus |  Cliterninus, a, um
Cliternum |  Cliternum, i n
Clitor |  Clitor, oris m
clitoris |  clitoris, idis f
Clitorium |  Clitorium, i n
Clitorius |  Clitorius, a, um
Clitumnus |  Clitumnus, i m
Clitus |  Clitus, i m
clivosus |  clivosus, a, um
clivus |  clivus, i m
cloaca |  cloaca, ae f
Clodianus |  Clodianus, a, um
Clodius |  Clodius, a, um
Cloelius |  Cloelius, a, um
Clofenoxinum |  Clofenoxin(um, i n
Clofibratum |  Clofibrat(um, i n
Clonidinum |  Clonidin(um, i n
Clortranum |  Clortran(um, i n
Closinum |  Closin(um, i n
clostra |  clostra, orum n
clostrum |  clostrum, i n
Clotho |  Clotho, us f
cludo |  cludo, clusi, clusum, ere
Cluentius |  Cluentius, a, um
Cluilius |  Cluilius, a, um
clunis |  clunis, is f
Clupea |  Clupea (Clypea), ae f
Clupeae |  Clupeae, arum f
clupeum |  clupeum, i n
clupeus |  clupeus, i m
Clusini |  Clusini, orum m
Clusinus |  Clusinus, a, um
Clusium |  Clusium, i n
Clusius |  Clusius, i m
Cluvia |  Cluvia, ae f
Cluvianus |  Cluvianus, a, um
Clymene |  Clymene, es f
Clymenejus |  Clymenejus, a, um
Clymenus |  Clymenus, i m
clyp |  clyp...
Clypea |  Clypea, ae f
Clytaemnestra |  Clytaemnestra (Clytemnestra), ae f
Clytemnestra |  Clytemnestra, ae f
Clytie |  Clytie, es f
Cn. |  Cn. сокр. от
Cnaeus |  Cnaeus (Cneus), i m
Cneus |  Cneus, i m
Cnidii |  Cnidii, orum m
Cnidius |  Cnidius (Gnldius), a, um
Cnidus |  Cnidus (-os) или Gnidus (-os), i f
Cnos |  Cnos...
Coa |  Coa, orum n
coacervo |  coacervo, avi, atum, are
coacesco |  coacesco, acui, --, ere
coactor |  coactor, oris m
coactus |  I coactus, a, um m
coaedifico |  coaedifico, avi, atum, are
coaequo |  coaequo, avi, atum, are
coagmento |  coagmento, avi, atum, are
coagmentum |  coagmentum, i n
coagulum |  coagulum, i n
coalesco |  coalesco, alui, alitum, ere
Coamidum |  Coamid(um, i n
coarc |  coarc...
coarguo |  coarguo, argui, argutum, ere
coartatio |  coartatio, onis f
coarto |  coarto, avi, atum, are
Cobadexum |  Cobadex(um, i n
Cobastabum |  Cobastab(um, i n
Cobilasum |  Cobilas(um, i n
Cobionum |  Cobion(um, i n
Cocainum |  Cocain(um, i n
Cocalus |  Cocalus, i m
Cocarbilum |  Cocarbil(um, i n
Cocarbosylum |  Cocarbosyl(um, i n
Cocarboxylasum |  Cocarboxylas(um, i n
Coccejus |  Coccejus, a, um
coccolithi |  coccolithi, orum m
coccum |  coccum, i n
coccygeus |  coccygeus, a, um анат.
coccyx |  coccyx, ygis m
cocdisco |  cocdisco, didici, --, ere
cochlea |  I cochlea (coclea), ae f
cochlear |  cochlear, aris n
cochleariformis |  cochleariformis, e анат.
cochlearis |  cochlearis, e анат.
coclea |  coclea, ae f
Cocles |  Cocles, itis m
coctilis |  coctilis, e
cocus |  cocus, i m
Cocytus |  Cocytus (-os), i m
Codeinum |  Codein(um, i n
Codelcortonum |  Codelcorton(um, i n
codex |  codex, icis m
codicarius |  codicarius, a, um
codicilli |  codicilli, orum m
codicillus |  codicillus, i m
Codinonum |  Codinon(um, i n
Codonum |  Codon(um, i n
Codrus |  Codrus, i m
Codterpinum |  Codterpin(um, i n
coelebs |  coelebs
Coelesyria |  Coelesyria, ae f
coelibatus |  coelibatus, us m
coelicola |  coelicola, ae m
coelifer |  coelifer, era, erum
Coelius |  Coelius, a, um
coelum |  coelum, i n
coemo |  coemo, emi, emptum, ere
coemptio |  coemptio, onis f
coena |  coena, ae f
coenautocinetum |  coenautocinetum, i n
coeno |  coeno, avi, atum, are
coenobiosis |  coenobiosis, is f
coenobium |  coenobium, i n
coenocarpium |  coenocarpium, i n
coenogenesis |  coenogenesis, is f
coenula |  coenula, ae f
coenum |  coenum, i n
coeo |  coeo, coii
coepio |  coepio, coepi, coeptum, ere
coepto |  coepto, avi, atum, are
coeptum |  coeptum, i n
coeptus |  coeptus, us m
coera |  coera, ae f
coerator |  coerator, oris m
coerceo |  coerceo, cui, citum, ere поэт.
coercitio |  coercitio, onis f
coero |  coero, avi, atum, are
coeruleus |  coeruleus, a, um
coetus |  coetus, us m
Coeus |  Coeus (=Coe^us), i m
Cofalginum |  Cofalgin(um, i n
Cofergotum |  Cofergot(um, i n
Coffeinum |  Coffein(um, i n
Coffenum |  Coffen(um, i n
Coffetaminum |  Coffetamin(um, i n
coffeum |  coffeum, i n
Coflavinasium |  Coflavinasium, i n
Coftadinum |  Coftadin(um, i n
cogilatio |  cogilatio, onis f
cogitate |  cogitate adv.
cogitatum |  cogitatum, i n
cogito |  cogito, avi, atum, are
cognatio |  cognatio, onis f
cognatus |  cognatus, a, um
cognitio |  cognitio, onis f
cognitor |  cognitor, oris m
cognitus |  cognitus, a, um
cognomen |  cognomen, inis n
cognomentum |  cognomentum, i n
cognominis |  cognominis, e
cognomino |  cognomino, avi, atum, are
cognosco |  cognosco, novi, nitum, ere
cogo |  cogo, coegi, coactum, ere преим.
cohaereo |  cohaereo, haesi, haesum, ere
cohaeresco |  cohaeresco, haesi, --, ere
cohenesto |  cohenesto, avi, atum, are
coheres |  coheres, edis m
cohibeo |  cohibeo, bui, bitum, ere
cohors |  cohors (cors, chors), tis f
cohortatio |  cohortatio, onis f
cohortor |  cohortor, atus sum, ari
Coi |  Coi, orum m
coitio |  coitio, onis f
coitus |  coitus, us m
Colcemidum |  Colcemid(um, i n
Colchaminum |  Colchamin(um, i n
Colchi |  Colchi, orum m
Colchicum |  Colchicum , i n
Colchicus |  Colchicus, a, um
Colchis |  I Colchis, idis f
Colchus |  I Colchus, a, um m
colens |  colens, entis
colentes |  colentes, ium m
Colepaxum |  Colepax(um, i n
colicus |  colicus, a, um анат.
Coliiformes |  Coliiformes, ium f
Colimycinum |  Colimycin(um, i n
colitis |  colitis, idis f
collabefacto |  collabefacto, (avi), atum, are
collabefio |  collabefio, factus sum, fieri
collabor |  collabor, lapsus sum, labi
collacrimo |  collacrimo, avi, atum, are
Collagenasum |  Collagenas(um, i n
collagenus |  collagenus, a, um анат.
collare |  collare, is n
Collargolum |  Collargol(um, i n
collateralis |  collateralis, e
Collatia |  Collatia, ae f
Collatini |  Collatini, orum m
Collatinus |  Collatinus, a, um
collatio |  collatio, onis f
collaudatio |  collaudatio, onis f
collaudo |  collaudo, avi, atum, are
collectio |  collectio, onis f
collega |  collega, ae m
collegium |  collegium, i n
collibertus |  collibertus, i m
collibet |  collibet (collubet), buit (bitum est), ere impers.
colliculus |  colliculus, i m
collido |  collido, lisi, lisum, ere pass.
colligo |  I colligo, avi, atum, are pass.
collino |  collino, levi, litum, ere
collinus |  I collinus, a, um
colliquefio |  colliquefio, factus sum, fieri
collis |  collis, is m
collocatio |  collocatio, onis f
colloco |  colloco, avi, atum, are
collocutio |  collocutio, onis f
colloquium |  colloquium, i n
colloquor |  colloquor, locutus (loquutus) sum, loqui
collubet |  collubet, buit (bitum est), ere
collubus |  collubus, i m
collucatus |  collucatus, a, um
colluceo |  colluceo, --, --, ere
colludo |  colludo, lusi, lusum, ere
collum |  collum, i n
colluo |  colluo, lui, lutum, ere
collusio |  collusio, onis f
collusor |  collusor, oris m
collustro |  collustro, avi, atum, are
colluvies |  colluvies, ei f
colluvio |  colluvio, onis f
collybus |  collybus (collubus), i m
collyrium |  collyrium, i n
colo |  colo, colui, cultum, ere преим.
colocasia |  colocasia, ae f
colocasium |  colocasium, i n
colon |  colon, i n
colona |  colona, ae f
Colonae |  Colonae, arum f
Coloneus |  Coloneus, a, um
colonia |  colonia, ae f
colonicus |  colonicus, a, um
colonoscopia |  colonoscopia, ae f
colonus |  colonus, i m
Colophon |  Colophon, onis f
Colophonii |  Colophonii, orum m
Colophonius |  Colophonius, a, um
color |  color ( арх.
coloratus |  coloratus, a, um
coloro |  coloro, avi, atum, are
colos |  colos, oris m
coloslomia |  coloslomia, ae f
colostrum |  colostrum, i n
colotomia |  colotomia, ae f
Colotonum |  Coloton(um, i n
colpitis |  colpitis, idis f
colpoptosis |  colpoptosis, is f
colposcopia |  colposcopia, ae f
coluber |  coluber, bri m
colubra |  colubra, ae f
colubrifer |  colubrifer, era, erum
colum |  colum, i n
columba |  columba, ae f
columbinus |  columbinus, a, um
columbus |  columbus, i m
columella |  columella, ae f
columen |  columen, inis n
columna |  columna, ae f
columnarius |  columnarius, a, um
columnurium |  columnurium, i n
colurnus |  colurnus, a, um
colus |  colus, us f
Colutoidum |  Colutoid(um, i n
coma |  coma, ae f
Comana |  Comana, orum n
comans |  comans, antis
comaro |  I comaro, avi, atum, are
Combantrinum |  Combantrin(um, i n
combibo |  combibo, bibi, --, ere
comburo |  comburo, bussi, bustum, ere
comedo |  comedo, edi, esum
Comenses |  Comenses, ium m
Comensis |  Comensis, e
comes |  comes, itis m
cometes |  cometes, ae m
comicus |  comicus, a, um
cominus |  cominus
comis |  comis, e
comissabundus |  comissabundus, a, um
comissatio |  comissatio, onis f
comissator |  comissator, oris m
comissor |  comissor, atus sum, ari
comitans |  comitans, antis
comitas |  comitas, atis f
comitatus |  comitatus,a, um
comiter |  comiter adv.
comitialis |  comitialis, e
comitium |  comitium, i n
comito |  comito, avi, atum, are
comitor |  comitor, atus sum, ari
commaculo |  commaculo, avi, atum, are
Commagena |  Commagena, ae f
Commagene |  Commagene, es f
Commagenus |  Commagenus, a, um
commeatus |  commeatus, us m
commemini |  commemini, isse defect.
commemorabilis |  commemorabilis, e
commemoratio |  commemoratio, onis f
commemoro |  commemoro, avi, atum, are
commendabilis |  commendabilis, e
commendaticius |  commendaticius, a, um
commendatio |  commendatio, onis f
commendatus |  commendatus, a, um
commendo |  commendo, avi, atum, are
commentariolum |  commentariolum, i n
commentariolus |  commentariolus, i m
commentarium |  commentarium, i n
commentarius |  commentarius, i m
commenticius |  commenticius, a, um
commentor |  I commentor, atus sum, ari m
commentum |  commentum, i n
commeo |  commeo, avi, atum, are
commercium |  commercium, i n
commercor |  commercor, atus sum, ari
commereo |  commereo, merui, meritum, ere
commigro |  commigro, avi, atum, are
commilitium |  commilitium, i n
commilito |  commilito, onis m
comminatio |  comminatio, onis f
commingo |  commingo, minxi, mictum (minctum) ere
comminiscor |  comminiscor, mentus sum, minisci преим.
comminor |  comminor, atus sum, ari
comminuo |  comminuo, minui, minutum, ere
comminus |  comminus adv.
commisceo |  commisceo, miscui, mixtum, ere
commiseror |  commiseror, atus sum, ari
commissum |  commissum, i n
commissura |  commissura, ae f
commissuralis |  commissuralis, e анат.
committo |  committo, misi, missum, ere pass.
commode |  commode adv.
commoditas |  commoditas, atis f
commodo |  commodo, avi, atum, are
commodum |  I commodum adv.
commodus |  commodus, a, um
commoenio |  commoenio, ivi, itum, ire
commonefacio |  commonefacio, feci, factum, ere
commoneo |  commoneo, ui, itum, ere
commorior |  commorior, mortuus sum, mori
commoror |  commoror, atus sum, ari
commotus |  commotus, a, um
commoveo |  commoveo, movi, motum, ere
commune |  commune, is n
communicans |  communicans, antis
communicatio |  communicatio, onis f
communico |  communico, avi, atum, are
communio |  I communio (commoenio), ivi, itum, ire f
communis |  communis, e
communitas |  communitas, atis f
communiter |  communiter adv.
commurmuror |  commurmuror, atus sum, ari
commutabilis |  commutabilis, e
commutatio |  commutatio, onis f
commuto |  commuto, avi, atum, are
como |  como, compsi, comptum, ere
comoedia |  comoedia, ae f
comoedus |  comoedus, i m
compactum |  compactum, i n
compactus |  compactus, а, um
compages |  compages, is f
compago |  compago, inis f
compar |  I compar, aris m
comparabilis |  comparabilis, e
comparatio |  I comparatio, onis f
comparativus |  comparativus, a, um
compareo |  compareo, ui, --, ere
Compazinum |  Compazin(um, i n
compectum |  compectum, i n
compellatio |  compellatio, onis f
compello |  I compello, avi, atum, are
compendium |  compendium, i n
compenso |  compenso, avi, atum, are
comperendinatus |  comperendinatus, us m
comperendino |  comperendino, avi, atum, are
comperio |  comperio, peri, pertum, ire преим.
comperior |  comperior, pertus sum, iri
compes |  compes, edis f
compesco |  compesco, pescui, --, ere
competitor |  competitor, oris m
competitrix |  competitrix, icis f
competo |  competo, ivi (ii), itum, ere
compilo |  compilo, avi, atum, are
compingo |  compingo, pegi, pactum, ere
Compitalia |  Compitalia, orum n
compitalicius |  compitalicius, a, um
compitum |  compitum, i n
complano |  complano, avi, atum, are
complector |  complector, plexus sum, plecti
complementatio |  complementatio, onis f
compleo |  compleo, plevi, pletum, ere
completus |  completus, a, um
complexio |  complexio, onis f
complexus |  complexus, us m
comploratio |  comploratio, onis f
comploratus |  comploratus, us m
comploro |  comploro, avi, atum, are
complures |  complures, a gen.
compono |  compono, posui, positum, ere
comporto |  comporto, avi, atum, are
compos |  compos, otis
composite |  composite adv.
compositio |  compositio, onis f
compositor |  compositor, oris m
compositus |  compositus, a, um
compotor |  compotor, oris m
compransor |  compransor, oris m
comprecatio |  comprecatio, onis f
comprecor |  comprecor, atus sum, ari
comprehendo |  comprehendo (comprendo), prehendi (prendi), prehensum (prensum), ere pass.
comprehensio |  comprehensio, onis f
comprendo |  comprendo, prendi, prensum, ere
compressor |  compressor, oris m
compressus |  compressus, us m
comprimo |  comprimo, pressi, pressum, ere
comprobo |  comprobo, avi, atum, are
compromissum |  compromissum, i n
compromitto |  compromitto, misi, missum, ere
Compsa |  Compsa, ae f
Compsanus |  Compsanus, a, um
comptus |  comptus, a, um
computator |  computator, oris m
computo |  computo, avi, atum, are
comtus |  comtus, a, um
Comum |  Comum, i n
comutatus |  comutatus, us m
conamen |  conamen, inis n
conarium |  conarium, i n
conatum |  conatum, i n
conatus |  conatus, us m
concalefacio |  concalefacio (concalfacio), feci, factum, ere
concalfacio |  concalfacio, feci, factum, ere
Concani |  Concani, orum m
concavo |  concavo, avi, atum, are
concavus |  I concavus, a, um анат.
concedo |  concedo, cessi, cessum, ere
concelebro |  concelebro, avi, atum, are
concenatio |  concenatio, onis f
concentio |  concentio, onis f
concentratum |  concentrat(um, i n
concentratus |  concentratus, a, um
concentus |  concentus, us m
conceptio |  conceptio, onis f
concerpo |  concerpo, cerpsi, cerptum, ere
concertatio |  concertatio, onis f
concerto |  concerto, avi, atum, are
concessio |  concessio, onis f
concessus |  concessus, us m
concha |  concha, ae f
conchalis |  conchalis, e анат.
concheus |  concheus, a, um
conchyliatus |  conchyliatus, a, um
conchylium |  conchylium, i n
concido |  I concido, cidi, --, ere
concieo |  concieo, civi, citum, ere
conciliabulum |  conciliabulum, i n
conciliatio |  conciliatio, onis f
conciliator |  conciliator, oris m
conciliatricula |  conciliatricula, ae f
conciliatrix |  conciliatrix, icis f
conciliatus |  conciliatus, a, um
concilio |  concilio, avi, atum, are
concilium |  concilium, i n
concinne |  concinne adv.
concinnus |  concinnus, a, um
concino |  concino, cinui, centum, ere
concio |  I concio, ivi, itum, ire f
concipio |  concipio, cepi, ceptum, ere
concitatio |  concitatio, onis f
concitator |  concitator, oris m
concitatus |  concitatus, a, um
concito |  concito, avi, atum, are преим.
concitor |  concitor, oris m
conciuncula |  conciuncula, ae f
conclamatio |  conclamatio, onis f
conclamo |  conclamo, avi, atum, are
conclave |  conclave, is n
concludo |  concludo, clusi, clusum, ere
conclusio |  conclusio, onis f
concoenatio |  concoenatio, onis f
concolur |  concolur, oris
concoqno |  concoqno, coxi, coctum, ere преим.
concordia |  I concordia, ae f
concorditer |  concorditer adv.
concordo |  concordo, avi, atum, are
concors |  concors, cordis
concrebresco |  concrebresco, brui, --, ere
concredo |  concredo, didi, ditum, ere
concrementum |  concrementum, i n
concremo |  concremo, avi, atum, are
concrepo |  concrepo, pui, pitum, ere
concresco |  concresco, crevi, cretum, ere
concubitus |  concubitus, us m
concubius |  concubius, a, um
conculco |  conculco, avi, atum, are
concumbo |  concumbo, cubui, cubitum, ere
concupisco |  concupisco, pivi (pii), pitum, ere
concurro |  concurro, curri (редко cucurri), cursum, ere
concursatio |  concursatio, onis f
concursator |  concursator, oris m
concurso |  concurso, avi, atum, are
concursus |  concursus, us m
concutio |  concutio, cussi, cussum, ere
Condelphinum |  Condelphin(um, i n
condemno |  condemno, avi, atum, are юр.
condensus |  condensus, a, um
condicio |  condicio, onis f
condico |  condico, dixi, dictum, ere
condimentum |  condimentum, i n
condio |  condio, ivi (ii), itum, ire
condiscipulus |  condiscipulus, i m
condisclpulatus |  condisclpulatus, us m
conditio |  conditio, onis f
conditor |  conditor, oris m
conditus |  conditus, a, um
condo |  condo, didi, ditum, ere преим.
condolesco |  condolesco, dolui, --, ere
condonatio |  condonatio, onis f
condono |  condono, avi, atum, are
Condrusi |  Condrusi, orum m
conduco |  conduco, duxi, ductum, ere
conducti |  conducti, orum m
conducticius |  conducticius, a, um
conductio |  conductio, onis f
conductor |  conductor, oris m
condylaris |  condylaris, e ����.
condyloideus |  condyloideus, a, um анат.
condylus |  condylus, i m
confectio |  confectio, onis f
confector |  confector, oris m
confectus |  confectus, a, um
confercio |  confercio, fersi, fertum, ire
confero |  confero, contuli, collatum (conlatum), conferre
confertim |  confertim adv.
confertus |  confertus, a, um
confervesco |  confervesco, bui, --, ere
confessio |  confessio, onis f
confessus |  confessus, a, um преим.
confestim |  confestim adv.
conficiens |  conficiens, entis
conficio |  conficio, feci, fectum, ere pass.
confictio |  confictio, onis f
confidens |  confidens, entis
confidenter |  confidenter adv.
confidentia |  confidentia, ae f
confido |  confido, fisus sum, ere
configo |  configo, fixi, fixum, ere
confingo |  confingo, finxi, fictum, ere
confinis |  confinis, e
confinium |  confinium, i n
confio |  confio, fectus sum, fieri
confirmatio |  confirmatio, onis f
confirmator |  confirmator, oris m
confirmatus |  confirmatus, a, um
confirmo |  confirmo, avi, atum, are
confiteor |  confiteor, fessus sum, eri
conflagro |  conflagro, avi, atum, are
conflicto |  conflicto, avi, atum, are pass.
conflictus |  conflictus, us m
confligo |  confligo, flixi, flictum, ere
conflo |  conflo, avi, atum, are pass.
confluens |  confluens, entis m
confluentes |  confluentes, ium m
confluo |  confluo, fluxi,--, ere
confodio |  confodio, fodi, fossum, ere
conformatio |  conformatio, onis f
conformo |  conformo, avi, atum, are
confragosa |  confragosa, orum n
confragosus |  confragosus, a, um
confremo |  confremo, ui, --, ere
confrico |  confrico, (fricavi), fricatum, are
confringo |  confringo, fregi, fractum, ere
confugio |  confugio, fugi, --, ere
confugium |  confugium, i n
confundo |  confundo, fudi, fusum, ere
confuse |  confuse adv.
confusio |  confusio, onis f
confusus |  confusus, a, um
confuto |  confuto, avi, atum, are
congelatio |  congelatio, onis f
congelo |  congelo, avi, atum, are
congemino |  congemino, avi, atum, are
congemo |  congemo, ui, --, ere
congenitus |  congenitus, a, um
conger |  conger, gri m
congeries |  congeries, ei f
congero |  congero, gessi, gestum, ere
congesticius |  congesticius, a, um
congiarium |  congiarium, i n
congius |  congius, i m
conglobo |  conglobo, avi, aturo, are pass.
conglutino |  conglutino, avi, atum, are
congratulor |  congratulor, atus sum, ari
congredior |  congredior, gressus sum, gredi
congregatus |  congregatus, a, um
congrego |  congrego, avi, atum, are pass.
congressio |  congressio, onis f
congressus |  congressus, us m
congruens |  congruens, entis
congruo |  congruo, ui, --, ere
conicio |  conicio, jeci, jectum, ere
conicus |  conicus, a, um
conifer |  conifer, era, erum
conitor |  conitor
coniveo |  coniveo, nivi (nixi), --, ere
conjectio |  conjectio, onis f
conjecto |  conjecto, avi, atum, are
conjectura |  conjectura, ae f
conjectus |  conjectus, us m
conjicio |  conjicio (conicio), jeci, jectum, ere
conjugata |  conjugata, ae f
conjugatio |  conjugatio, onis f
conjugialis |  conjugialis, e
conjugiun |  conjugiun, i n
conjugo |  conjugo, avi, atum, are
conjuncte |  conjuncte adv.
conjunctim |  conjunctim adv.
conjunctio |  conjunctio, onis f
conjunctiva |  conjunctiva, ae f
conjunctivalis |  conjunctivalis, e анат.
conjunctivus |  conjunctivus, a, um грам.
conjunctus |  conjunctus, a, um
conjungo |  conjungo, junxi, junctum, ere pass.
conjunx |  conjunx (и conjux), jugis f
conjurati |  conjurati, orum m
conjuratio |  conjuratio, onis f
conjuratus |  conjuratus, a, um
conjuro |  conjuro, avi, atum, are
conjux |  conjux), jugis m
conl |  conl...
conm |  conm...
connecto |  connecto, nexui, nexum, ere
connexio |  connexio, onis f
connexus |  I connexus, a, um m
connitor |  connitor, nisus (nixus) sum, niti
conniveo |  conniveo (coniveo), nivi (nixi), --, ere
connubialis |  connubialis, e
connubium |  connubium, i n
conoides |  conoides, is
conoideus |  conoideus, a, um
conopium |  conopium, i n
conor |  conor, atus sum, ari
conquasso |  conquasso, avi, atum, are
conqueror |  conqueror, questus sum, queri
conquestio |  conquestio, onis f
conquestus |  conquestus, us m
conquiesco |  conquiesco, quievi, quietum, ere
conquiro |  conquiro, quisivi, quisitum, ere преим.
conquisitio |  conquisitio, onis f
conquisitor |  conquisitor, oris m
consaepio |  consaepio, saepsi, saeptum, ire
consaeptum |  consaeptum, i n
consaluto |  consaluto, avi, atum, are
consanguineus |  I consanguineus, a, um m
consanguinitas |  consanguinitas, atis f
consceleratus |  consceleratus, a, um
conscelero |  conscelero, avi, utuni, are
conscendo |  conscendo, scendi, scensum, ere
conscientia |  conscientia, ae f
conscindo |  conscindo, scidi, scissum, ere
conscio |  conscio, --, --, ire
conscisco |  conscisco, scivi (scii), scitum, ere
conscius |  I conscius, a, um m
conscribo |  conscribo, scripsi, scriptum, ere
conscriptio |  conscriptio, onis f
conseco |  conseco, secui, sectum, are
consecratio |  consecratio, onis f
consecratus |  consecratus, a, um
consecro |  consecro, avi, atum, are
consector |  consector, atus sum, ari
consecutio |  consecutio (consequutio), onis f
consenesco |  consenesco, senui, --, ere преим.
consensio |  consensio, onis f
consensus |  consensus, us m
consentaneus |  consentaneus, a, um
Consentia |  Consentia, ae f
Consentini |  Consentini, orum m
Consentinus |  Consentinus, a, um
consentio |  consentio, sensi, sensum, ire
consepio |  consepio, sepsi, septum, ire
consequor |  consequor, secutus (sequutus) sum, sequi
consequutio |  consequutio, onis f
consero |  I consero, serui, sertum, ere юр.
conserva |  conserva, ae f
conservatio |  conservatio, onis f
conservator |  conservator, oris m
conservo |  conservo, avi, atum, are преим.
conservus |  conservus, i m
consessor |  consessor, oris m
consessus |  consessus, us m
considerate |  considerate adv.
consideratus |  consideratus, a, um
considero |  considero, avi, atum, are
consido |  consido, sedi, sessum, ere воен.
consigno |  consigno, avi, atum, are
consiliarius |  consiliarius, i m
consilior |  consilior, atus sum, ari
consilium |  consilium, i n
consimilis |  consimilis, e
consipio |  consipio, --, --, ere
consisto |  consisto, stiti, --, ere воен.
consitor |  consitor, oris m
consobrina |  consobrina, ae f
consobrinus |  consobrinus, i m
consociatio |  consociatio, onis f
consocio |  consocio, avi, atum, are
consolatio |  consolatio, onis f
consolator |  consolator, oris m
consolatus |  consolatus, a, um
consolor |  consolor, atus sum, ari
consono |  consono, sonui, --, are
consonus |  consonus, a, um
consors |  I consors, sortis m
consortio |  consortio, onis f
consortium |  consortium, i n
conspectus |  I conspectus, a, um m
conspergo |  conspergo, spersi, spersum, ere
conspiciendus |  conspiciendus, a, um
conspicio |  conspicio, spexi, spectum, ere pass.
conspicor |  conspicor, atus sum, ari
conspicuus |  conspicuus, a, um
conspiratio |  conspiratio, onis f
conspiro |  conspiro, avi, atum, are
conspuo |  conspuo, spui, sputum, ere
constans |  constans, antis
constanter |  constanter adv.
constantia |  constantia, ae f
Constantinopolis |  Constantinopolis, is f
Constantinus |  Constantinus, i m
Constantius |  Constantius, i m
consternatio |  consternatio, onis f
consternatus |  consternatus, a, um
consterno |  I consterno, avi, atum, are pass.
Constimolum |  Constimol(um, i n
constipo |  constipo, avi, atum, are
constituens |  constituens, entis
constituo |  constituo, stitui, stitutum, ere воен.
constitutio |  constitutio, onis f
constitutum |  constitutum, i n
consto |  consto, stiti, staturus, are
constrictor |  constrictor, oris m
constringo |  constringo, strinxi, strictum, ere
construo |  construo, struxi, structum, ere
constuprator |  constuprator, oris m
constupro |  constupro, avi, atum, are
Consualia |  Consualia, ium n
consuasor |  consuasor, oris m
consuefacio |  consuefacio, feci, factum, ere
consuesco |  consuesco, suevi, suetum, ere
consuetudo |  consuetudo, inis f
consuetus |  consuetus, a, um
consul |  consul, ulis m
consularis | consularis, e
consulariter |  consulariter adv.
consulatus |  consulatus, us m
consulo |  consulo, sului, sultum, ere
consultatio |  consultatio, onis f
consulte |  consulte adv.
consulto |  I consulto adv.
consultor |  consultor, oris m
consultum |  consultum, i n
consultus |  I consultus, a, um m
consummo |  consummo, avi, atum, are
consumo |  consumo, sumpsi, sumptum, ere pass.
consurgo |  consurgo, surrexi, surrectum, ere
consurrectio |  consurrectio, onis f
Consus |  Consus, i m
contabulatio |  contabulatio, onis f
contabulo |  contabulo, avi, atnni, are
contabundus |  contabundus, a, um
contactus |  contactus, us m
contagio |  contagio, onis f
contaminatus |  contaminatus, a, um
contamino |  contamino, avi, atum, are
Contebenum |  Conteben(um, i n
contego |  contego, texi, tectum, ere
contemero |  contemero, avi, --, are
contemnendus |  contemnendus, a, um
contemno |  contemno, tempsi, temptum, ere
contemplatus |  contemplatus, us m
contemplor |  contemplor, platus sum, ari
contemptim |  contemptim adv.
contemptio |  contemptio, onis f
contemptor |  contemptor, oris m
contemptrix |  contemptrix, icis f
contemptus |  I contemptus, a, um m
contendo |  contendo, tendi, tentum, ere
contentio |  contentio, onis f
contentus |  I contentus, a, um
conterminus |  conterminus, a, um
contero |  contero, trivi, tritum, ere
conterreo |  conterreo, terrui, territum, ere
contestatio |  contestatio, onis f
contestor |  contestor, atus sum, ari
contexo |  contexo, texui, textum, ere
contextus |  contextus, a, um
conticesco |  conticesco (conticisco), ticui, --, ere
conticisco |  conticisco, ticui, --, ere
contignatio |  contignatio, onis f
contigno |  contigno, (avi), atum, are
contiguus |  contiguus, a, um
continens |  I continens, entis f
continentalis |  continentalis, e
continenter |  continenter adv.
continentia |  continentia, ae f
contineo |  contineo, tinui, tentum, ere pass.
contingo |  contingo, tigi, tactum, ere
continuatio |  continuatio, onis f
continuo |  I continuo adv.
continuus |  continuus, a, um
contio |  contio, onis f
contionabundus |  contionabundus, a, um
contionalis |  contionalis, e
contionator |  contionator, oris m
contionor |  contionor, atus sum, ari
Contominum |  Contomin(um, i n
contor |  contor, atus sum, ari
contorqueo |  contorqueo, torsi, tortum, ere
contortus |  contortus, a, um
contra |  I contra adv.
Contraceptinum |  Contraceptin(um, i n
contraceptivus |  contraceptivus, a, um мед.
contractio |  contractio, onis f
contracto |  contracto, avi, atum, are
contractus |  contractus, a, um
contradico |  contradico, dixi, dictum, ere
Contrahelminum |  Contrahelmin(um, i n
contraho |  contraho, traxi, tractum, ere pass.
Contrapotum |  Contrapot(um, i n
contraria |  contraria, orum n
contrarium |  contrarium, i n
contrarius |  contrarius, a, um
contrecto |  contrecto (contracto), avi, atum, are
contremisco |  contremisco, mui, --, ere
contribuo |  contribuo, tribui, tributum, ere
Contricalum |  Contrical(um, i n
contristo |  contristo, avi, atum, are
controversia |  controversia, ae f
controversiosus |  controversiosus, a, um
controversus |  controversus, a, um
contrucido |  contrucido, avi, atum, are
contrudo |  contrudo, trusi, trusum, ere
contubernalis |  contubernalis, is m
contubernium |  contubernium, i n
contueor |  contueor, tuitus sum, eri
contumacia |  contumacia, ae f
contumaciter |  contumaciter adv.
contumax |  contumax, acis
contumelia |  contumelia, ae f
contumeliose |  contumeliose adv.
contumeliosus |  contumeliosus, a, um
contumulo |  contumulo, avi, atum, are
contundo |  contundo, tudi, tusum, ere
conturbatus |  conturbatus, a, um
conturbo |  conturbo, avi, atum, are
contus |  contus, i m
conubium |  conubium (connubium), i n
conus |  conus, i m
convalesco |  convalesco, valui, --, ere
Convallaria |  Convallaria, ae f
Convallatoxinum |  Convallatoxin(um, i n
convallis |  convallis, is f
Convallopanum |  Convallopan(um, i n
convecto |  convecto, --, atus, are
conveho |  conveho, vexi, vectum, ere
convello |  convello, velli, vulsum, ere
convena |  convena, ae m
conveniens |  conveniens, entis
convenienter |  convenienter adv.
convenientia |  convenientia, ae f
convenio |  convenio, veni, ventum, ire
conventiculum |  conventiculum, i n
conventio |  conventio, onis f
conventum |  conventum, i n
conventus |  conventus, us m
convergentia |  convergentia, ae f
conversatio |  conversatio, onis f
conversio |  conversio, onis f
converto |  converto (convorto), verti (vorti), versum (vorsum), ere pass.
convestio |  convestio, ivi, itum, ire
convexa |  convexa, orum n
convexum |  I convexum, i n
conviciator |  conviciator (convitiator), oris m
convicior |  convicior (convitior), atus sum, ari
convicium |  convicium (convitium), i n
convictor |  convictor, oris m
convictus |  convictus, us m
convinco |  convinco, vici, victum, ere
conviso |  conviso, --, --, ere
convit |  convit...
conviva |  conviva, ae m
convivalis |  convivalis, e
convivator |  convivator, oris m
convivialis |  convivialis, e
convivium |  convivium, i n
convivor |  convivor, atus sum, ari
convocatio |  convocatio, onis f
convoco |  convoco, avi, atum, are
convolo |  convolo, avi, atum, are
Convolpurum |  Convolpur(um, i n
convoltus |  convoltus, a, um
convolvo |  convolvo, volvi, volutum, ere
convomo |  convomo, --, --, ere
convorto |  convorto, vorti, vorsum, ere
cooperio |  cooperio (coperio), perui, pertum, ire
cooptatio |  cooptatio (coptatio), onis f
coopto |  coopto (copto), avi, atum, are
coorior |  coorior, ortus sum, iri
Coos |  Coos, i f
Copae |  Copae, arum f
Copais |  Copais, idis f
coperio |  coperio, perui, pertum, ire
Cophartenum |  Copharten(um, i n
copia |  copia, ae f
copiose |  copiose adv.
copiosus |  copiosus, a, um
copo |  copo, onis m
coptatio |  coptatio, onis f
copto |  copto, avi, atum, are
copula |  copula, ae f
copulo |  copulo, avi, atum, are
coquo |  coquo, coxi, coctum, ere
coquus |  coquus (cocus), i m
cor |  cor, cordis n
Cora |  Cora, ae f
coracoacromialis |  coracoacromialis, e анат.
coracobrachialis |  coracobrachialis, e анат.
coracoclavicularis |  coracoclavicularis, e анат.
coracoides |  coracoides, is
coracoideus |  coracoideus, a, um
Corafuronum |  Corafuron(um, i n
Coralgilum |  Coralgil(um, i n
Coralli |  Coralli, orum m
corallium |  corallium (curalium), i n
coram |  I coram adv.
Coraminum |  Coramin(um, i n
Corazolum |  Corazol(um, i n
Corbella |  Corbella, ae f
corbis |  corbis, is f
Corbulo |  Corbulo, onis m
Corchorozidum |  Corchorozid(um, i n
corcodilus |  corcodilus, i m
Corcyra |  Corcyra, ae f
Corcyraei |  Corcyraei, orum m
Corcyraeus |  Corcyraeus, a, um
Cordalenum |  Cordalen(um, i n
Cordexum |  Cordex(um, i n
Cordiaminum |  Cordiamin(um, i n
Cordiasidum |  Cordiasid(um, i n
Cordigitum |  Cordigit(um, i n
Cordioxylum |  Cordioxyl(um, i n
Corduba |  Corduba, ae f
Cordubenses |  Cordubenses, ium m
Cordubensis |  Cordubensis, e
Corduena |  Corduena, arum f
Cordueni |  Cordueni, orum m
Corelborinum |  Corelborin(um, i n
Coresidum |  Coresid(um, i n
Corfiniensis |  Corfiniensis, e
Corfinium |  Corfinium, i n
Corglyconum |  Corglycon(um, i n
Corinthia |  Corinthia, orum n
Corinthiacus |  Corinthiacus, a, um
Corinthii |  Corinthii, orum m
Corinthius |  Corinthius, a, um
Corinthus |  Corinthus, i f
Coriolani |  Coriolani, orum m
Coriolanus |  Coriolanus, a, um
Corioli |  Corioli, orum m
Coriosolites |  Coriosolites, um m
corium |  corium, i n
cornea |  cornea, ae f
cornealis |  cornealis, e анат.
Cornelianus |  Cornelianus, a, um
Cornelius |  I Cornelius, a, um
Cornerinum |  Cornerin(um, i n
corneus |  I corneus, a, um
cornicen |  cornicen, inis m
cornicula |  cornicula, ae f
Corniculanus |  Corniculanus, a, um
corniculatus |  corniculatus, a, um
corniculum |  I corniculum, i n
corniformis |  corniformis, e
corniger |  corniger, era, erum
cornipes |  cornipes, edis
cornix |  cornix, icis f
cornu |  cornu, us n
cornum |  cornum, i n
cornus |  I cornus, i f
Corodilum |  Corodil(um, i n
corollarium |  corollarium, i n
corona |  corona, ae f
Coronaei |  Coronaei, orum m
coronalis |  coronalis, e анат.
Coronalum |  Coronal(um, i n
Coronarinum |  Coronarin(um, i n
coronarius |  coronarius, a, um анат.
Corone |  Corone, es f
Coronea |  Coronea, ae f
Coronensis |  Coronensis, e
Coroneus |  Coroneus (=Corone^us), ei m
Coronides |  Coronides, ae m
Coroninum |  Coronin(um, i n
Coronis |  Coronis, idis f
corono |  corono, avi, atum, are pass.
coronoides |  coronoides, is анат.
Corontinum |  Corontin(um, i n
Corosanum |  Corosan(um, i n
Coroxinum |  Coroxin(um, i n
corporeus |  corporeus, a, um
corpus |  corpus, oris n
corpusculum |  corpusculum, i m
correctio |  correctio, onis f
corrector |  corrector, oris m
correpo |  correpo, repsi, reptum, ere
correpte |  correpte adv.
corrigo |  corrigo, rexi, rectum, ere
corripio |  corripio, ripui, reptum, ere
corroboro |  corroboro, avi, atum, are pass.
corrogo |  corrogo, avi, atum, are
corrugator |  corrugator, oris m
corrugo |  corrugo, avi, atum, are
corrumpo |  corrumpo, rupi, ruptum, ere
corruo |  corruo, rui, --, ere
corruptela |  corruptela, ae f
corruptio |  corruptio, onis f
corruptor |  corruptor, oris m
corruptus |  corruptus, a, um
cors |  cors, tis f
Corsi |  Corsi, orum m
Corsica |  Corsica, ae f
Corsicus |  Corsicus, a, um
Corsus |  Corsus, a, um
Cortadrenum |  Cortadren(um, i n
Cortarmurum |  Cortarmur(um, i n
Cortatum |  Cortat(um, i n
Cortefum |  Cortef(um, i n
Cortelanum |  Cortelan(um, i n
Cortenilum |  Cortenil(um, i n
cortex |  cortex, icis m
Cortexonum |  Cortexon(um, i n
Cortibelum |  Cortibel(um, i n
corticalis |  corticalis, e анат.
Corticocinum |  Corticocin(um, i n
corticofugalis |  corticofugalis, e анат.
corticohypothalamicus |  corticohypothalamicus, a, um анат.
corticonuclearis |  corticonuclearis, e анат.
corticopontinus |  corticopontinus, a, um анат.
corticoreticularis |  corticoreticularis, e анат.
corticospinalis |  corticospinalis, e анат.
corticothalamicus |  corticothalamicus, a, um анат.
Corticotrophinum |  Corticotrophin(um, i n
Corticotropinum |  Corticotropin(um, i n
Cortideltum |  Cortidelt(um, i n
Cortigenum |  Cortigen(um, i n
cortina |  cortina, ae f
Cortinum |  Cortin(um, i n
Cortironum |  Cortiron(um, i n
Cortisatum |  Cortisat(um, i n
Cortisidum |  Cortisid(um, i n
Cortisolum |  Cortisol(um, i n
Cortisonum |  Cortison(um, i n
Cortistabum |  Cortistab(um, i n
Cortistalum |  Cortistal(um, i n
Cortisylum |  Cortisyl(um, i n
Cortona |  Cortona, ae f
Cortonenses |  Cortonenses, ium m
Cortonensis |  Cortonensis, e
Cortonum |  Corton(um, i n
Cortrancylum |  Cortrancyl(um, i n
Cortrilum |  Cortril(um, i n
Cortrophinum |  Cortrophin(um, i n
corulus |  corulus, i f
Corus |  Corus, i m
corusco |  corusco, --, --, are
coruscus |  coruscus, a, um
Corvalolum |  Corvalol(um, i n
Corvantinum |  Corvantin(um, i n
Corvitolum |  Corvitol(um, i n
Corvotonum |  Corvoton(um, i n
corvus |  corvus, i m
Corybantius |  Corybantius, a, um
Corybas |  Corybas, antis m
Corycius |  I Corycius, a, um
Corycus |  I Corycus (-os), i f
coryletum |  coryletum, i n
corylus |  corylus (corulus), i f
corymbifer |  corymbifer, era, erum
corymbus |  corymbus, i m
corytus |  corytus (-os), i m
cos |  I cos, cotis f
Cosa |  Cosa, ae f
cosmoe |  cosmoe, orum m
Cossa |  Cossa (Cosa), ae f
Cossae |  Cossae, arum f
Cossani |  Cossani, orum m
Cossanus |  Cossanus, a, um
Cossura |  Cossura, ae f
Cossyra |  Cossyra (Cosyra) f
costa |  costa, ae f
costalis |  costalis, e анат.
costarius |  costarius, a, um анат.
costochondralis |  costochondralis, e анат.
costodiaphragmaticus |  costodiaphragmaticus, a, um анат.
costoensiformis |  costoensiformis, e анат.
costomediastinalis |  costomediastinalis, e анат.
costosternalis |  costosternalis, e анат.
costotransversarius |  costotransversarius, a, um анат.
costovertebralis |  costovertebralis, e анат.
costoxiphoideus |  costoxiphoideus, a, um анат.
costum |  costum, i n
Cosura |  Cosura, ae f
Cosyra |  Cosyra, ae f
Cothermopsum |  Cothermops(um, i n
Cothiaminum |  Cothiamin(um, i n
cothurnatus |  cothurnatus, a, um
cothurnus |  cothurnus, i m
cotid |  cotid...
Cotiliae |  Cotiliae, arum f
Cotinazinum |  Cotinazin(um, i n
Cotta |  Cotta, ae m
coturnix |  coturnix, icis f
Cotus |  Cotus, i m
cotyla |  cotyla, ae f
cotyledo |  cotyledo, onis f
cotylicus |  cotylicus, a, um анат.
cotyloideus |  cotyloideus, a, um анат.
Cotys |  Cotys, yis m
Cotyttia |  Cotyttia, orum n
Cotytto |  Cotytto, us f
Coum |  Coum, i n
Cous |  I Cous, a, um f
coxa |  coxa, ae f
Crabra |  Crabra, ae f
crabro |  crabro, onis m
Cragus |  Cragus, i m
cranialis |  cranialis, e анат.
Cranii |  Cranii, orum m
craniologia |  craniologia, ae f
cranium |  cranium, i n
Crannon |  Crannon, onis f
Cranon |  Cranon (Crannon), onis f
Cranonius |  Cranonius, a, um
Crantor |  Crantor, oris m
crapula |  crapula, ae f
cras |  cras adv.
crasse |  crasse adv.
crassitudo |  crassitudo, inis f
crassus |  I crassus, a, um m
crastinus |  crastinus, a, um
Crataegus |  Crataegus, i f
Crataeis |  Crataeis, idis f
crater |  crater, eris m
cratera |  cratera, ae f
Craterus |  Craterus, i m
crates |  crates, is f
Crathis |  Crathis, idis m
Cratinus |  Cratinus, i m
Cratippus |  Cratippus, i m
creator |  creator, oris m
creatrix |  creatrix, icis f
creber |  creber, bra, brum
crebesco |  crebesco, brui, --, ere
crebra |  crebra adv.
crebresco |  crebresco (crebesco), brui, --, ere
crebritas |  crebritas, atis f
crebro |  crebro adv.
credibilis |  credibilis, e
credibiliter |  credibiliter adv.
creditor |  creditor, oris m
creditum |  creditum, i n
credo |  credo, didi, ditum, ere
credulitas |  credulitas, atis f
credulus |  credulus, a, um
cremaster |  cremaster, eris m
cremastericus |  cremastericus, a, um анат.
Cremera |  Cremera, ae m
Cremerensis |  Cremerensis, e
cremo |  cremo, avi, atum, are
Cremona |  Cremona, ae f
Cremonenses |  Cremonenses, ium m
Cremonensis |  Cremonensis, e
Cremonis |  Cremonis jugum n
cremor |  cremor, oris m
crena |  crena, ae f
creo |  creo, avi, atum, are
crepida |  crepida, ae f
crepidatus |  crepidatus, a, um
crepido |  crepido, inis f
crepito |  crepito, --, --, are
crepitus |  crepitus, us m
crepo |  crepo, pui, pitum, are
crepundia |  crepundia, orum n
crepusculum |  crepusculum, i n
Cres |  Cres, etis m
cresco |  cresco, crevi, cretum, ere
Cresius |  Cresius, a, um
Cressa |  Cressa, ae f
Cressius |  Cressius, a, um
creta |  I creta, ae f
Cretaeus |  Cretaeus, a, um
Crete |  Crete, es f
Cretenses |  Cretenses, ium m
Cretensis |  Cretensis, e
Creticus |  Creticus, a, um
Cretis |  Cretis, idis f
cretosus |  cretosus, a, um
cretula |  cretula, ae f
cretus |  cretus, a, um part.
Creusa |  Creusa, ae f
cribrosus |  cribrosus, a, um
cribrum |  cribrum, i n
cricoesophageus |  cricoesophageus, a, um анат.
cricoideus |  cricoideus, a, um анат.
cricopharyngeus |  cricopharyngeus, a, um анат.
cricotrachealis |  cricotrachealis, e анат.
crimen |  crimen, inis n
criminatio |  criminatio, onis f
criminor |  criminor, atus sum, ari преим.
criminose |  criminose adv.
criminosus |  criminosus, a, um
Crimissus |  Crimissus, i m
crinale |  crinale, is n
crinalis |  crinalis, e
crinis |  crinis, is m
crinotus |  crinotus, a, um преим.
crispo |  crispo, avi, atum, are
crispus |  crispus, a, um
crista |  crista, ae f
Cristallovarum |  Cristallovar(um, i n
Cristapuratum |  Cristapurat(um, i n
cristatus |  cristatus, a, um
Cristodiginum |  Cristodigin(um, i n
Crithote |  Crithote, es f
Critias |  Critias, ae m
criticus |  criticus, i m
Crito |  Crito, onis m
croceus |  croceus, a, um
crocodilus |  crocodilus, i m
crocota |  crocota, ae f
crocotula |  crocotula, ae f
crocum |  crocum, i n
crocus |  crocus, i m
Croesus |  Croesus, i m
Cromadrenalum |  Cromadrenal(um, i n
Cromosilum |  Cromosil(um, i n
Cromoxinum |  Cromoxin(um, i n
Cromyon |  Cromyon, onis f
crotalum |  crotalum, i n
Crotenalum |  Crotenal(um, i n
Croto |  Croto (Croton), onis f, m
Croton |  Croton, onis f, m
Crotoniates |  Crotoniates, ae m
Crotonienses |  Crotonienses, ium m
Crotoniensis |  Crotoniensis, e
Crotopiades |  Crotopiades, ae m
cruciamentum |  cruciamentum, i n
cruciatus |  I cruciatus, a, um m
cruciformis |  cruciformis, e
Crucinum |  Crucin(um, i n
crucio |  crucio, avi, atum, are
crudelis |  crudelis, e
crudelitas |  crudelitas, atis f
crudeliter |  crudeliter adv.
crudesco |  crudesco, dui, --, ere
crudus |  crudus, a, um поэт.
cruento |  cruento, avi, atum, are
cruentus |  I cruentus, a, um
crumena |  crumena (crumina), ae f
crumina |  crumina, ae f
cruor |  cruor, oris m
crus |  crus, cruris n
crusta |  crusta, ae f
crustulum |  crustulum, i n
crustum |  crustum, i n
Crustumeria |  Crustumeria, ae f
Crustumerii |  Crustumerii, orum m
Crustumerium |  Crustumerium, i n
Crustumini |  Crustumini, orum m
Crustuminus |  Crustuminus, a, um
Crustumium |  Crustumium, i n
Crustumius |  Crustumius, a, um
crux |  crux, crucis f
cryophilus |  cryophilus, a, um биолог.
cryophyton |  cryophyton, i n
crypta |  crypta, ae f
cryptocarpus |  cryptocarpus, a, um бот.
Cryptocillinum |  Cryptocillin(um, i n
Cryptonolum |  Cryptonol(um, i n
cryptophyton |  cryptophyton, i n
crystallisatus |  crystallisatus, a, (um, i n
Crystoserpinum |  Crystoserpin(um, i n
Crystovibexum |  Crystovibex(um, i n
Ctenocephalus |  Ctenocephalus, i n
Ctenophora |  Ctenophora, orum n
Ctesiphon |  Ctesiphon, ontis f
cubicularius |  cubicularius, i m
cubiculum |  cubiculum, i n
cubile |  cubile, is n
cubital |  cubital, alis n
cubitalis |  cubitalis, e анат.
cubito |  cubito, avi, --, are
cubitum |  cubitum, i n
cubitus |  cubitus, i m
cubo |  cubo, bui, bitum, are
cubocuneiformis |  cubocuneiformis, e анат.
cuboideonavicularis |  cuboideonavicularis, e анат.
cuboideus |  cuboideus, a, um
cubonavicularis |  cubonavicularis, e анат.
cuculla |  cuculla, ae f
cucullaris |  cucullaris, e
cuculus |  cuculus, i m
cucumerarium |  cucumerarium, i n
cucumis |  cucumis, eris m
cudo |  cudo, (cudi), (cusum), ere
cuicuimodi |  cuicuimodi
cujas |  cujas арх.
cujatis |  cujatis, is
cujus |  cujus, a, um
cujusmodi |  cujusmodi
cujusquemodi |  cujusquemodi
culeum |  culeum, i n
culeus |  culeus (culleus), i m
culex |  culex, icis m
culina |  culina, ae f
culleum |  culleum, i n
culleus |  culleus, i m
culmen |  culmen, inis n
culmus |  culmus, i m
culopexia |  culopexia, ae f
culpa |  culpa, ae f
culpo |  culpo, avi, atum, are
culta |  culta, orum n
culte |  culte adv.
cultellus |  cultellus, i m
culter |  culter, tri m
cultio |  cultio, onis f
cultor |  cultor, oris m
cultrix |  cultrix, icis f
cultura |  cultura, ae f
cultus |  I cultus, a, um m
culullus |  culullus, i m
cum |  I cum conj.
Cumae |  Cumae, arum f
Cumaeus |  Cumaeus, a, um
Cumani |  Cumani, orum m
Cumanum |  Cumanum, i n
Cumanus |  Cumanus, a, um
cumba |  cumba, ae f
cumera |  cumera, ae f
Cumidum |  Cumid(um, i n
cuminum |  cuminum (cyminum) i n
cummaxime |  cummaxime (quummaxime)
cumque |  cumque (cunque, quomque) adv.
cumulate |  cumulate adv.
cumulatus |  cumulatus, a, um
cumulo |  cumulo, avi, atum, are
cumulus |  I cumulus, i m
cunabula |  cunabula, orum m
cunae |  cunae, arum f
cunctabundus |  cunctabundus, a, um
cunctans |  cunctans, antis
cunctanter |  cunctanter adv.
cunctatio |  cunctatio, onis f
cunctator |  cunctator, oris m
cunctor |  cunctor (contor), atus sum, ari
cunctus |  cunctus, a, um
cunealis |  cunealis, e анат.
cuneatim |  cuneatim adv.
cuneatus |  cuneatus, a, um
cuneiformis |  cuneiformis, e
cuneocuboideus |  cuneocuboideus, a, um анат.
cuneometatarseus |  cuneometatarseus, a, um анат.
cuneonavicularis |  cuneonavicularis, e анат.
cuneus |  cuneus, i m
cuniculus |  cuniculus, i m
cunnus |  cunnus, i m
cunque |  cunque
cupa |  cupa, ae f
cupide |  cupide adv.
Cupidineus |  Cupidineus, a, um
cupiditas |  cupiditas, atis f
cupido |  I cupido, inis f
cupidus |  cupidus, a, um
cupiens |  cupiens, entis
cupio |  cupio, ivi (ii), itum, ere
cupresseus |  cupresseus, a, um
cupressifer |  cupressifer, era, erum
cupressus |  cupressus, i f
Cuprum |  Cuprum, i n
cupula |  cupula, ae f
cupularis |  cupularis, e анат.
cur |  cur adv.
cura |  cura ( арх.
Curacholinum |  Curacholin(um, i n
Curacitum |  Curacit(um, i n
Curalestum |  Curalest(um, i n
curalium |  curalium, i n
Curantylum |  Curantyl(um, i n
curatio |  curatio, onis f
curator |  curator ( арх.
curculio |  curculio, onis m
Curensis |  Curensis, e
Cures |  Cures, ium f
Curetes |  Curetes, um m
Curetis |  Curetis, idis f
curia |  curia, ae f
Curianus |  Curianus, a, um
Curiatii |  Curiatii, orum m
curiatus |  curiatus, a, um
curio |  I curio, onis m
Curiosolites |  Curiosolites, um m
curiosus |  curiosus, a, um
curis |  curis, is f
Curius |  Curius, a, um
curo |  curo, avi, atum, are
curriculum |  curriculum, i n
curro |  curro, cucurri, cursum, ere
currus |  currus, us m
cursim |  cursim adv.
cursito |  cursito, avi, --, are
curso |  curso, --, --, are
cursor |  cursor, oris m
cursus |  cursus, us m
Curtius |  Curtius, a, um
curto |  curto, avi, atum, are
curtus |  curtus, a, um
curulis |  curulis, e
curvamen |  curvamen, inis n
curvatura |  curvatura, ae f
curvilineus |  curvilineus, a, um
curvo |  curvo, avi, atum, are
curvus |  curvus, a, um
Curythus |  Curythus, i f
cuspidalis |  cuspidalis, e
cuspidatus |  cuspidatus, a, um
cuspis |  cuspis, idis f
custodia |  custodia, ae f
custodio |  custodio, ivi (ii), itum, ire
custos |  custos, odis m
Cusus |  Cusus, i m
cutaneus |  cutaneus, a, um
cuticula |  cuticula, ae f
Cutiliae |  Cutiliae (Cotiliae), arum f
Cutilum |  Cutil(um, i n
cutis |  cutis, is f
Cutivitolum |  Cutivitol(um, i n
Cutizonum |  Cutizon(um, i n
Cyacetacidum |  Cyacetacid(um, i n
Cyamidum |  Cyamid(um, i n
cyanatus |  cyanatus, a, um хим.
Cyane |  Cyane, es f
Cyaneae |  Cyaneae, arum f
Cyanee |  Cyanee, es f
cyanidum |  cyanidum, i n
Cyanizidum |  Cyanizid(um, i n
Cyanocobalaminum |  Cyanocobalamin(um, i n
Cyanophyta |  Cyanophyta, orum n
cyathus |  cyathus, i m
Cyazidum |  Cyazid(um, i n
cybaeus |  cybaeus, а, um
Cybebe |  Cybebe, es f
Cybele |  Cybele, es f
Cybeleius |  Cybeleius, a, um
Cybistra |  Cybistra, orum n
Cyclades |  Cyclades, um f
Cyclamidum |  Cyclamid(um, i n
Cyclamycinum |  Cyclamycin(um, i n
Cyclas |  Cyclas, adis f
cyclicus |  cyclicus, a, um
Cyclobarbitalum |  Cyclobarbital(um, i n
Cyclobarbitonum |  Cyclobarbiton(um, i n
Cyclobutonium |  Cyclobutonium, i n
Cyclocarinum |  Cyclocarin(um, i n
Cyclodolum |  Cyclodol(um, i n
Cycloestrolum |  Cycloestrol(um, i n
Cyclohexalum |  Cyclohexal(um, i n
Cyclomethiazidum |  Cyclomethiazid(um, i n
Cyclomycinum |  Cyclomycin(um, i n
Cyclonalum |  Cyclonal(um, i n
Cyclopanum |  Cyclopan(um, i n
Cyclopenthiazidum |  Cyclopenthiazid(um, i n
Cyclophosphamidum |  Cyclophosphamid(um, i n
Cyclophosphanum |  Cyclophosphan(um, i n
Cyclopius |  Cyclopius, a, um
Cyclopropanum |  Cyclopropan(um, i n
Cyclops |  Cyclops, opis m
Cyclosedalum |  Cyclosedal(um, i n
Cycloserinum |  Cycloserin(um, i n
Cyclostomata |  Cyclostomata, orum n
Cycluralum |  Cyclural(um, i n
Cycneius |  Cycneius, a, um
cycneus |  cycneus (cygneus), a, um
cycnus |  I cycnus (cygnus), i m
Cycobeminum |  Cycobemin(um, i n
Cycoplexum |  Cycoplex(um, i n
Cycvalonum |  Cycvalon(um, i n
Cydnus |  Cydnus (-os), i m
Cydon |  Cydon, onis m
Cydoneus |  Cydoneus, a, um поэт.
Cydonia |  I Cydonia f
Cydoniatae |  Cydoniatae, arum m
cydonium |  cydonium, i n
Cydonius |  Cydonius, a, um поэт.
Cygerolum |  Cygerol(um, i n
cygneus |  cygneus, a, um
cygnus |  I cygnus, i m
cylinder |  cylinder, dri m
cylindricus |  cylindricus, a, um
cylindrus |  cylindrus, i m
Cylla |  Cylla, ae f
Cyllene |  Cyllene, es f
Cylleneus |  Cylleneus, a, um
Cyllenis |  Cyllenis, idis f
Cyllenius |  Cyllenius, a, um
Cylon |  Cylon, onis m
Cylonius |  Cylonius, a, um
Cymaei |  Cymaei, orum m
Cymaeus |  Cymaeus, a, um
Cymarinum |  Cymarin(um, i n
cymba |  I cymba (cumba), ae f
cymbalum |  cymbalum, i n
cymbium |  cymbium, i n
Cyme |  Cyme, es f
cyminum |  cyminum, i n
Cynici |  Cynici, orum m
cynicus |  cynicus, a, um
Cynosarges |  Cynosarges, is n
Cynoscephalae |  Cynoscephalae, arum f
Cynosura |  Cynosura, ae f
Cynosurae |  Cynosurae, arum f
Cynthius |  Cynthius, a, um
Cynthus |  Cynthus, i m
Cynus |  Cynus (-os), i f
cyparissus |  cyparissus, i f
Cyprii |  Cyprii, orum m
Cyprinoformes |  Cyprinoformes, ium m
cyprinus |  cyprinus, i m
Cyprius |  I Cyprius, a, um
cyprum |  cyprum, i n
Cyprus |  Cyprus (-os), i f
Cyrenae |  Cyrenae, arum f
Cyrenaei |  Cyrenaei, orum m
Cyrenaeus |  Cyrenaeus, a, um
Cyrenaici |  Cyrenaici, orum m
Cyrenaicus |  Cyrenaicus, a, um
Cyrene |  Cyrene, es f
Cyrenenses |  Cyrenenses, ium m
Cyrenensis |  Cyrenensis, e
Cyrneus |  Cyrneus, a, um
Cyrnus |  Cyrnus (-os), i f
Cyrtaei |  Cyrtaei (Cyrtii), orum m
Cyrtii |  Cyrtii, orum m
Cyrus |  Cyrus, i m
Cyssus |  Cyssus, untis f
cysta |  cysta, ae f
Cystaminum |  Cystamin(um, i n
Cysteaminum |  Cysteamin(um, i n
cystectomia |  cystectomia, ae f
Cysteinum |  Cystein(um, i n
Cystenalum |  Cystenal(um, i n
cysticus |  cysticus, a, um анат.
Cystinaminum |  Cystinamin(um, i n
cystis |  cystis, is f
cystitis |  cystitis, idis f
cystocarpium |  cystocarpium, i n
Cystogenum |  Cystogen(um, i n
cystogramma |  cystogramma, atis n
cystographia |  cystographia, ae f
cystolithiasis |  cystolithiasis, is f
cystolithus |  cystolithus, i m
cystoplegia |  cystoplegia, ae f
cystopyelogramma |  cystopyelogramma, atis n
cystopyelographia |  cystopyelographia, ae f
cystoscopia |  cystoscopia, ae f
cystostomia |  cystostomia, ae f
cystosus |  cystosus, a, um мед.
cystotomia |  cystotomia, ae f
Cytaconum |  Cytacon(um, i n
Cythera |  Cythera, orum n
Cytherea |  Cytherea, ae f
Cythereias |  Cythereias, adis f
Cythereis |  Cythereis, idis f
Cytherejus |  Cytherejus, a, um
Cytheriacus |  Cytheriacus, a, um
cytisum |  cytisum, i n
cytisus |  cytisus, i m
Cytitonum |  Cytiton(um, i n
Cytobexum |  Cytobex(um, i n
Cytobionum |  Cytobion(um, i n
Cytoflavum |  Cytoflav(um, i n
Cytofolum |  Cytofol(um, i n
cytogenesis |  cytogenesis, is f
cytogramma |  cytogramma, atis n
cytolithus |  cytolithus, i m
cytologia |  cytologia, ae f
cytolysis |  cytolysis, is f
Cytonalum |  Cytonal(um, i n
cytoplasma |  cytoplasma, atis n
Cytoriacus |  Cytoriacus, a, um
Cytorus |  Cytorus, i m
Cytoxanum |  Cytoxan(um, i n
cytus |  cytus, i m
Cyziceni |  Cyziceni, orum m
Cyzicenus |  Cyzicenus, a, um
Cyzicum |  Cyzicum, i n
Cyzicus |  Cyzicus (-os), i f
