ea |  ea adv.
eadem |  eadem adv.
Ebenales |  Ebenales, ium f
ebenus |  ebenus (hebenus), i f
ebibo |  ebibo, bibi, --, ere поэт.
eblandior |  eblandior, itus sum, iri
Eboracum |  Eboracum, i n
ebrietas |  ebrietas, atis f
ebriosus |  ebriosus, a, um
ebrius |  ebrius, a, um
ebulum |  ebulum, i n
ebulus |  ebulus, i m
ebur |  ebur, oris n
eburneus |  I eburneus, a, um анат.
eburnus |  eburnus, a, um
Eburones |  Eburones, um m
Ebutolum |  Ebutol(um, i n
Ecbatana |  Ecbatana, orum n
ecce |  ecce adv.
ecdurus |  ecdurus, a, um
ecf |  ecf...
ecfercio |  ecfercio, --, fertum, ire
ecfodio |  ecfodio, fodi, fossum, ere
echeneis |  echeneis, idis f
echidna |  I echidna, ae f
Echinopanax |  Echinopanax, acis f
echinus |  echinus, i m
echo |  echo, us f
ecloga |  ecloga, ae f
Eclorilum |  Ecloril(um, i n
Ecmolinum |  Ecmolin(um, i n
ecquando |  ecquando adv.
ecqui |  ecqui, ecquae (ecqua), ecquod
ecquid |  ecquid adv.
ecquis |  ecquis, ecquid
ecquo |  ecquo adv.
ectoderma |  ectoderma, atis n
ectoplasma |  ectoplasma, atis n
ectropion |  ectropion, i n
eculeus |  I eculeus, a, um m
eczema |  eczema, atis n
Edatacalum |  Edatacal(um, i n
edax |  edax, acis
Edecrilum |  Edecril(um, i n
Edecrinum |  Edecrin(um, i n
eder |  eder...
Ederenum |  Ederen(um, i n
edico |  edico, dixi, dictum, ere
edictum |  edictum, i n
Edionum |  Edion(um, i n
edisco |  edisco, edidici, --, ere
edissero |  edissero, serui, sertum, ere
edisserto |  edisserto, avi, atum, are
editicius |  editicius, a, um
editio |  editio, onis f
editus |  editus, a, um
edo |  I edo, didi, ditum, ere pass.
edoceo |  edoceo, docui, doctum, ere
edomo |  edomo, ui, itum, are
edormio |  edormio, ivi, itum, ire
educatio |  educatio, onis f
educator |  educator, oris m
educo |  I educo, avi, atum, are
edulis |  edulis, e
edurus |  edurus (ecdurus), a, um
Efcamonum |  Efcamon(um, i n
effarcio |  effarcio (effercio, ecfercio), --, fertum, ire поэт.
effatum |  effatum, i n
effectus |  effectus, us m
effeminatus |  effeminatus, a, um
effemino |  effemino, avi, atum, are
efferatus |  efferatus, a, um
effercio |  effercio, --, fertum, ire
efferens |  efferens, entis анат.
effero |  I effero (ecfero), extuli, elatum, efferre pass.
efferus |  efferus (ecferus), a, um
effervesco |  effervesco, ferbui (fervi), --, ere
effervo |  effervo, --, --, ere поэт.
effetus |  effetus, a, um
efficacitas |  efficacitas, atis f
efficaciter |  efficaciter adv.
efficax |  efficax, acis
efficio |  efficio, feci, fectum, ere
effigies |  effigies, ei f
effingo |  effingo, finxi, fictum, ere
efflagitatus |  efflagitatus, us m
efflagito |  efflagito, avi, atum, are
efflo |  efflo, avi, atum, are
effloresco |  effloresco, florui, --, ere
effluo |  effluo, fluxi, fluxum, ere
effodio |  effodio (ecfodio, exfodio), fodi, fossum, ere
effor |  effor, fatus sum, fari
effrenate |  effrenate adv.
effrenatio |  effrenatio, onis f
effrenatus |  effrenatus, a, um
effrenus |  effrenus, a, um
effringo |  effringo, fregi, fractum, ere
effugio |  effugio, fugi, fugitum, ere
effugium |  effugium, i n
effulgeo |  effulgeo, fulsi, --, ere
effultus |  effultus, a, um
effundo |  effundo, fudi, fusum, ere pass.
effuse |  effuse adv.
effusus |  effusus, a, um
effutio |  effutio, (ivi), itum, ire
Efloranum |  Efloran(um, i n
eflusio |  eflusio, onis f
egelidus |  egelidus, a, um
egens |  egens, entis
egenus |  egenus, a, um
egeo |  egeo, gui, --, ere
Egeria |  Egeria, ae f
egero |  egero, gessi, gestum, ere
egestas |  egestas, atis f
Egevitum |  Egevit(um, i n
ego |  ego gen.
egomet |  egomet
egredior |  egredior, gressus sum, gredi воен.
egregia |  egregia, orum n
egregie |  egregie adv.
egregius |  egregius, a, um
egressus |  egressus, us m
eheu |  eheu
ei |  ei (hei)
eia |  eia (heia)
eicio |  eicio, ieci, iectum, ere
einissarius |  einissarius, a, um анат.
ejaculatorius |  ejaculatorius, a, um анат.
ejaculor |  ejaculor, atus sum, ari
ejectio |  ejectio, onis f
ejecto |  ejecto, --, --, are
ejer |  ejer...
ejero |  ejero, avi, atum, are
ejicio |  ejicio (eicio), jeci, jectum, ere воен.
ejulatio |  ejulatio, onis f
ejulatus |  ejulatus, us m
ejulo |  ejulo, avi, atum, are
ejuro |  ejuro (ejero), avi, atum, are юр.
ejusmodi |  ejusmodi
elabor |  elabor, lapsus sum, labi
elaboratus |  elaboratus, a, um
elaboro |  elaboro, avi, atum, are
elanguesco |  elanguesco, gui, --, ere
elasticus |  elasticus, a, um анат.
elate |  elate adv.
elaterium |  elaterium, i n
Elatinum |  Elatin(um, i n
elatio |  elatio, onis f
elatro |  elatro, --, --, are
Elatrolum |  Elatrol(um, i n
Elavilum |  Elavil(um, i n
Eldrinum |  Eldrin(um, i n
Elecorum |  Elecor(um, i n
electio |  electio, onis f
Electra |  Electra, ае f
electrocardiogramma |  electrocardiogramma, atis n
electrocardiographia |  electrocardiographia, ae f
electroencephalogramma |  electroencephalogramma, atis n
electroencephalographia |  electroencephalographia, ae f
electrum |  electrum, i n
electus |  I electus, a, um m
elegans |  elegans, antis
eleganter |  eleganter adv.
elegantia |  elegantia, ae f
elegeia |  elegeia, ae f
elegi |  elegi, orum m
elegia |  elegia (elegeia), ae f
elementum |  elementum, i n
Elenium |  Elenium, i n
elephanthiasis |  elephanthiasis, is f
elephantus |  elephantus, i m
elephas |  elephas, antis m
Eleudronum |  Eleudron(um, i n
Eleusin |  Eleusin, inis f
elevator |  elevator, oris m
elevo |  elevo, avi, atum, are
elicio |  elicio, cui, citum, ere
elido |  elido, lisi, lisum, ere
eligo |  eligo, legi, lectum, ere
elimino |  elimino, avi, atum, are
elimo |  elimo, avi, atum, are
elinguis |  elinguis, e
Elinolum |  Elinol(um, i n
Elis |  Elis, idis f
elixir |  elixir, iris n
elixus |  elixus, a, um
elleborum |  elleborum
ellipsoideus |  ellipsoideus, a, um анат.
ellipticus |  ellipticus, a, um анат.
ellops |  ellops
ellum |  ellum, ellam см.
eloco |  eloco, avi, atum, are
elocutio |  elocutio, onis f
elogium |  elogium, i n
elops |  elops
eloquens |  eloquens, entis
eloquentia |  eloquentia, ae f
eloquium |  eloquium, i n
eloquor |  eloquor, locutus (loquutus) sum, loqui
eluceo |  eluceo, luxi, --, ere
eluctor |  eluctor, atus sum, ari
eludo |  eludo, lusi, lusum, ere
elugeo |  elugeo, luxi, --, ere
eluo |  eluo, lui, lutum, ere
elutus |  elutus, a, um
eluvies |  eluvies, ei f
eluvio |  eluvio, onis f
Elysium |  Elysium, i n
em |  em
Emaformum |  Emaform(um, i n
emancipo |  emancipo (emancupo), avi, atum, are
emancupo |  emancupo, avi, atum, are
Emandionum |  Emandion(um, i n
Emanilum |  Emanil(um, i n
emano |  emano, avi, atum, are
ematuresco |  ematuresco, turui, --, ere
emax |  emax, acis прот.
Embioptera |  Embioptera, orum n
Embitolum |  Embitol(um, i n
emblema |  emblema, atis n
embolia |  embolia, ae f
emboliformis |  emboliformis, e анат.
embolium |  embolium, i n
embryogenesis |  embryogenesis, is f
embryologia |  embryologia, ae f
embryon |  embryon, i n
embryonalis |  embryonalis, e анат.
embryotomia |  embryotomia, ae f
Embutalum |  Embutal(um, i n
emendabilis |  emendabilis, e
emendate |  emendate adv.
emendatio |  emendatio, onis f
emendator |  emendator, oris m
emendatus |  emendatus, a, um
emendo |  emendo, avi, atum, are
ementior |  ementior, titus sum, iri
emereo |  emereo, merui, meritum, ere pass.
emereor |  emereor, meritus sum, eri
emergo |  emergo, merui, mersum, ere pass.
emeritus |  emeritus, a, um
emetior |  emetior, mensus sum, iri
emico |  emico, micui, micatum, are поэт.
emigro |  emigro, avi, atum, are
eminens |  eminens, entis
eminentia |  eminentia, ae f
emineo |  emineo, minui, --, ere
eminus |  eminus adv.
emiror |  emiror, atus sum, ari
emissarium |  emissarium, i n
emissarius |  emissarius, i m
emissio |  emissio, onis f
emitto |  emitto, misi,missum, ere воен.
emo |  emo, emi, emptum, ere
emoderor |  emoderor, --, ari
emodulor |  emodulor, --, ari
emolimentum |  emolimentum, i n
emollio |  emollio, ivi, itum, ire
emolumentum |  emolumentum (emolimentum), i n
emoriens |  emoriens, entis
emorior |  emorior, mortuus sum, mori
emoveo |  emoveo, movi, motum, ere
Empedocles |  Empedocles, is m
emphysema |  emphysema, atis n
emplastrum |  emplastrum, i n
emporium |  emporium, i n
emptio |  emptio, onis f
emptor |  emptor, oris m
emptum |  emptum, i n
empyema |  empyema, atis n
emulgens |  emulgens, entis фармац.
emulsio |  emulsio, onis f
emulsum |  emulsum, i n
emungo |  emungo, munxi, munctum, ere
emunio |  emunio, ivi (ii), itum, ire
en |  en
enamelum |  enamelum, i n
enanthema |  enanthema, atis n
enarrabilis |  enarrabilis, e
enarro |  enarro, avi, atum, are
enarthrosis |  enarthrosis, is f
enascor |  enascor, natus sum, nasci
Enatinum |  Enatin(um, i n
enato |  enato, avi, atum, are
enavigo |  enavigo, avi, atum, are
encephalitis |  encephalitis, idis f
encephalocele |  encephalocele, es f
encephalographia |  encephalographia, ae f
encephalomyelitis |  encephalomyelitis, idis f
encephalon |  encephalon, i n
encephalopathia |  encephalopathia, ae f
endo |  endo (indo) арх.
endocarditis |  endocarditis, idis f
endocardium |  endocardium, i n
endocervicalis |  endocervicalis, e анат.
endocervicitis |  endocervicitis, idis f
endocrinicus |  endocrinicus, a, um анат.
endocrinologia |  endocrinologia, ae f
endoderma |  endoderma, atis n
Endodormum |  Endodorm(um, i n
endogenus |  endogenus, a, um биолог.
Endolinum |  Endolin(um, i n
endolympha |  endolympha, ae f
endometritis |  endometritis, idis f
endometrium |  endometrium, i n
endomyocardialis |  endomyocardialis, e мед.
endomysium |  endomysium, i n
endoneurium |  endoneurium, i n
endopeduncularis |  endopeduncularis, e анат.
endopelvicus |  endopelvicus, a, um анат.
endophthalmitis |  endophthalmitis, idis f
endoplasma |  endoplasma, atis n
endorachis |  endorachis, is f
endospora |  endospora, ae f
endosteum |  endosteum, i n
endothelium |  endothelium, i n
endothoracicus |  endothoracicus, a, um анат.
Endoxanum |  Endoxan(um, i n
Endoxycrinum |  Endoxycrin(um, i n
Enduxanum |  Enduxan(um, i n
eneco |  eneco (enico), necui, nectum, are
energeticus |  energeticus, a, um
enervatus |  enervatus, a, um
enervo |  enervo, avi, atum, are
Enhexymalum |  Enhexymal(um, i n
enico |  enico, avi, --, are
Enidranum |  Enidran(um, i n
enim |  enim conj.
Enimalum |  Enimal(um, i n
enimvero |  enimvero
enise |  enise adv.
enisus |  enisus, a, um см.
eniteo |  eniteo, tui, --, ere
enitesco |  enitesco, --, --, ere
enitor |  enitor, nisus (nixus) sum, niti
enixe |  enixe (enise) adv.
enixus |  enixus (enisus), a, um
enneapetalus |  enneapetalus, a, um бот.
Ennius |  Ennius, i m
ennuntiatum |  ennuntiatum, i n
eno |  eno, avi, atum, are поэт.
enodatio |  enodatio, onis f
enodis |  enodis, e
enophthalmus |  enophthalmus, i m
Enovidum |  Enovid(um, i n
ensiformis |  ensiformis, e анат.
ensiger |  ensiger, era, erum
ensis |  ensis, is m
Entacylum |  Entacyl(um, i n
Entamoeba |  Entamoeba, ae f
Entazinum |  Entazin(um, i n
entericus |  entericus, a, um анат.
Enteritanum |  Enteritan(um, i n
enterocolitis |  enterocolitis, idis f
Enterokinolum |  Enterokinol(um, i n
enterolithus |  enterolithus, i m
Enteromonum |  Enteromon(um, i n
enteron |  enteron, i n
enteropathia |  enteropathia, ae f
enteropexia |  enteropexia, ae f
enteroplastica |  enteroplastica, ae f
Enteroquinolum |  Enteroquinol(um, i n
enterorrhagia |  enterorrhagia, ae f
enterorrhaphia |  enterorrhaphia, ae f
Enterosalum |  Enterosal(um, i n
Enterosalylum |  Enterosalyl(um, i n
Enterosanum |  Enterosan(um, i n
Enteroseptolum |  Enteroseptol(um, i n
enterostomia |  enterostomia, ae f
Enterotoninum |  Enterotonin(um, i n
Entizolum |  Entizol(um, i n
entoderma |  entoderma, atis n
Entromonum |  Entromon(um, i n
Entrononum |  Entronon(um, i n
Enturenum |  Enturen(um, i n
enubo |  enubo, nupsi, nuptum, ere
enucleatus |  enucleatus, a, um
enucleo |  enucleo, avi, atum, are
enudo |  enudo, avi, atum, are
enumeratio |  enumeratio, onis f
enumero |  enumero, avi, atum, are
enuntio |  enuntio, avi, atum, are
enuptio |  enuptio, onis f
enutrio |  enutrio, ivi, --, ire
eo |  I eo adv.
eodem |  eodem adv.
Eos |  Eos f
Epaminondas |  Epaminondas, ае m
Epanutinum |  Epanutin(um, i n
epastus |  epastus, a, um
ependyma |  ependyma, atis n
epenthesis |  epenthesis, is f
Ephalonum |  Ephalon(um, i n
ephebus |  ephebus, i m
Ephedrinum |  Ephedrin(um, i n
Ephedrolum |  Ephedrol(um, i n
Ephedrosanum |  Ephedrosan(um, i n
ephemeris |  ephemeris, idis f
Ephesus |  Ephesus, i f
Ephetoninum |  Ephetonin(um, i n
ephippiatus |  ephippiatus, a, um
ephippium |  ephippium, i n
ephorus |  ephorus, i m
epibranchialis |  epibranchialis, e зоолог.
epicardium |  epicardium, i n
epicerebralis |  epicerebralis, e анат.
Epicharmus |  Epicharmus, i m
epicondylus |  epicondylus, i m
epicranialis |  epicranialis, e анат.
epicranius |  epicranius, a, um анат.
epicrisis |  epicrisis, is f
Epicurus |  Epicurus, i m
epicus |  epicus, a, um
Epidauros |  Epidauros, i f
epidemicus |  epidemicus, a, um мед.
epidemiologia |  epidemiologia, ae f
epidermis |  epidermis, idis f
epididymis |  epididymis, idis f
Epidionum |  Epidion(um, i n
epidularis |  epidularis, e анат.
epifascialis |  epifascialis, e анат.
epigastralgia |  epigastralgia, ae f
epigastricus |  epigastricus, a, um анат.
epigastrium |  epigastrium, i n
epiglottis |  epiglottis, idis f
epigramma |  epigramma, atis n
epilepsia |  epilepsia, ae f
Epilinum |  Epilin(um, i n
epilogus |  epilogus, i m
Epimidum |  Epimid(um, i n
Epinephrinum |  Epinephrin(um, i n
epinephros |  epinephros, i m
epineurium |  epineurium, i n
epiorchium |  epiorchium, i n
epipharynx |  epipharynx, yngis f
epiphysialis |  epiphysialis, e анат.
epiphysis |  epiphysis, is f
epiploicus |  epiploicus, a, um анат.
epiploon |  epiploon, i n
epiptericus |  epiptericus, a, um анат.
Epirenanum |  Epirenan(um, i n
Epirinaminum |  Epirinamin(um, i n
Epirus |  Epirus (Epiros), i f
episcleralis |  episcleralis, e анат.
episternalis |  episternalis, e анат.
epistola |  epistola (epistula), ae f
epistriatum |  epistriatum, i n
epistropheus |  epistropheus, i m
epistula |  epistula, ae f
epitaphius |  epitaphius, i m
epitendineum |  epitendineum, i n
epithalamus |  epithalamus, i m
epithelialis |  epithelialis, e анат.
epithelium |  epithelium, i n
epitome |  epitome, es f
epitympanicus |  epitympanicus, a, um анат.
epodes |  epodes, um m
epodos |  epodos, i m
Epontolum |  Epontol(um, i n
eponychium |  eponychium, i n
epoophoron |  epoophoron, i n
epops |  epops, opis m
Eporalum |  Eporal(um, i n
epos |  epos n
epoto |  epoto, --, epotus, are
Eprazinum |  Eprazin(um, i n
Epsicapronum |  Epsicapron(um, i n
Eptoinum |  Eptoin(um, i n
epulae |  epulae, arum f
epularis |  epularis, e
epulo |  epulo, onis m
epulor |  epulor, atus sum, ari
epulum |  epulum, i n
EQ.R. |  EQ.R. сокр. от
equa |  equa, ae f
Equanilum |  Equanil(um, i n
equator |  equator, oris m
eques |  eques, itis m
equester |  equester, stris, stre
equidem |  equidem adv.
equinus |  I equinus, a, um анат.
Equiria |  Equiria, ium n
Equisetum |  Equisetum, i n
equitatus |  equitatus, us m
equito |  equito, avi, atum, are
equuleus |  equuleus (eculeus), i m
equus |  equus, i m
ER. |  ER. сокр. от
era |  era, ae f
erado |  erado, rasi, rasum, ere
Eragrostis |  Eragrostis, idis f
Eraminum |  Eramin(um, i n
Erato |  Erato, us f
Eratosthenes |  Eratosthenes, is m
Eravermum |  Eraverm(um, i n
ercisco |  ercisco, --, --, ere
Ercoquinum |  Ercoquin(um, i n
erctum |  erctum, i n
erector |  erector, oris m
erectus |  erectus, a, um
erepo |  erepo, repsi, --, ere
ereptio |  ereptio, onis f
ereptor |  ereptor, oris m
eres |  eres, edis m
Eretria |  Eretria, ae f
Erevitum |  Erevit(um, i n
erga |  erga praep.
Ergaminum |  Ergamin(um, i n
Ergamum |  Ergam(um, i n
ergasterium |  ergasterium, i n
ergastulum |  ergastulum, i n
ergo |  I ergo conj.
Ergocalciferolum |  Ergocalciferol(um, i n
Ergoclinum |  Ergoclin(um, i n
Ergofeinum |  Ergofein(um, i n
Ergoffinum |  Ergoffin(um, i n
Ergostabilum |  Ergostabil(um, i n
Ergotalum |  Ergotal(um, i n
Ergotaminum |  Ergotamin(um, i n
Ergotartratum |  Ergotartrat(um, i n
Ergotexum |  Ergotex(um, i n
Ergotinum |  Ergotin(um, i n
Ergotoxinum |  Ergotoxin(um, i n
ericius |  ericius, i m
Eridanum |  Eridan(um, i n
Eridanus |  Eridanus, i m
erigo |  erigo, erexi, erectum, ere
Erinys |  Erinys, yus f
eripio |  eripio, ripui, reptum, ere pass.
Eritrocina |  Eritrocina, ae f
Ermetrinum |  Ermetrin(um, i n
erogo |  erogo, avi, atum, are
Erpozidum |  Erpozid(um, i n
errabundus |  errabundus, a, um
erraticus |  erraticus, a, um
erratio |  erratio, onis f
errator |  errator, oris m
erratum |  erratum, i n
erratus |  erratus, us m
erro |  I erro, avi, atum, are m
error |  error, oris m
erubescendus |  erubescendus, a, um
erubesco |  erubesco, rubui, --, ere
eruca |  eruca, ae f
eructo |  eructo, avi, atum, are
erudio |  erudio, ivi (ii), itum, ire
erudite |  erudite adv.
eruditi |  eruditi, orum m
eruditio |  eruditio, onis f.
eruditus |  eruditus, a, um
erumpo |  erumpo, rupi, ruptum, ere pass.
eruo |  eruo, rui, rutum, ere
eruptio |  eruptio, onis f
erus |  erus, i m
ervum |  ervum, i n
Erynitum |  Erynit(um, i n
Erysiminum |  Erysimin(um, i n
Erysimosidum |  Erysimosid(um, i n
Erysimum |  Erysim(um, i n
erythema |  erythema, etis n
Erythraeus |  Erythraeus, a, um
erythroblastus |  erythroblastus, i m
erythrocytopenia |  erythrocytopenia, ae f
erythrocytosis |  erythrocytosis, is f
erythrocytus |  erythrocytus, i m
erythrodermia |  erythrodermia, ae f
Erythromycinum |  Erythromycin(um, i n
erythropoesis |  erythropoesis, is f
esca |  esca, ae f
escendo |  escendo, scendi, scensum, ere
escensio |  escensio, onis f
Escodolum |  Escodol(um, i n
esculentus |  I esculentus, a, um
Esculozidum |  Esculozid(um, i n
Escuzanum |  Escuzan(um, i n
esophagectasia |  esophagectasia, ae f
esophageus |  esophageus, a, um анат.
esophagospasmus |  esophagospasmus, i m
esophagostenosis |  esophagostenosis, is f
esophagus |  esophagus, i m
esplano |  esplano, avi, atum, are
Esquiliae |  Esquiliae, arum f
Esqunlinus |  Esqunlinus, a, um
essedarius |  essedarius, i m
essedum |  essedum, i n
essurio |  essurio, --, riturus, ire
Estigynum |  Estigyn(um, i n
Estrenum |  Estren(um, i n
Estrilum |  Estril(um, i n
Estrobenum |  Estroben(um, i n
Estromeninum |  Estromenin(um, i n
Estronalum |  Estronal(um, i n
Estronum |  Estron(um, i n
Estrugenonum |  Estrugenon(um, i n
Estrusolum |  Estrusol(um, i n
esurio |  esurio (essurio), --, riturus, ire
et |  et conj.
Etaperazinum |  Etaperazin(um, i n
etenim |  etenim conj.
Eteocles |  Eteocles, is (eos) m
etesiae |  etesiae, arum m
Etfortilum |  Etfortil(um, i n
Ethambutolum |  Ethambutol(um, i n
Ethidolum |  Ethidol(um, i n
Ethinoralum |  Ethinoral(um, i n
Ethiodanum |  Ethiodan(um, i n
Ethionamidum |  Ethionamid(um, i n
Ethisteronum |  Ethisteron(um, i n
ethmoideomaxillaris |  ethmoideomaxillaris, e анат.
Ethocainum |  Ethocain(um, i n
Ethodinum |  Ethodin(um, i n
Ethoformum |  Ethoform(um, i n
Ethomorphinum |  Ethomorphin(um, i n
Ethylmorphinum |  Ethylmorphin(um, i n
Ethymalum |  Ethymal(um, i n
etiam |  etiam conj.
etiamnum |  etiamnum adv.
etiamnunc |  etiamnunc
etiamsi |  etiamsi conj.
etiamtum |  etiamtum adv.
etiamtunc |  etiamtunc
Eticyclinum |  Eticyclin(um, i n
Eticyclolum |  Eticyclol(um, i n
Etiocarlidum |  Etiocarlid(um, i n
Etionizina |  Etionizina, ae f
Etivexum |  Etivex(um, i n
Etruria |  Etruria, ae f
etsi |  etsi conj.
eu |  eu interj.
euan |  euan interj
euans |  euans (euhans), antis
Eubinum |  Eubin(um, i n
Euboea |  Euboea, ae f
Eubolinum |  Eubolin(um, i n
eucalyptus |  eucalyptus, i f
Euclaminum |  Euclamin(um, i n
Euclides |  Euclides, is m
Eucodalum |  Eucodal(um, i n
Eucortonum |  Eucorton(um, i n
Eudormum |  Eudorm(um, i n
Euflavinum |  Euflavin(um, i n
eugenica |  eugenica, ae f
euhans |  euhans, antis
euhoe |  euhoe
Eukratonum |  Eukraton(um, i n
Eulaevomycetinum |  Eulaevomycetin(um, i n
Eulaxinum |  Eulaxin(um, i n
Eumenides |  Eumenides, um f
Euniazidum |  Euniazid(um, i n
Eunoctinum |  Eunoctin(um, i n
eunuchus |  eunuchus, i m
euoe |  euoe
Eupasalum |  Eupasal(um, i n
Euphodynum |  Euphodyn(um, i n
euphoria |  euphoria, ae f
Euphrates |  Euphrates, is m
Euphyllinum |  Euphyllin(um, i n
Eupraminum |  Eupramin(um, i n
Euripides |  Euripides, is m
euripus |  euripus, i m
Europa |  Europa, ae f
Eurotas |  Eurotas, ae m
eurous |  eurous, a, um
eurus |  eurus, i m
eurycladus |  eurycladus, a, um бот.
euryphagia |  euryphagia, ae f
eurytopus |  eurytopus, a, um биолог.
Euspiranum |  Euspiran(um, i n
Eusterolum |  Eusterol(um, i n
Eustigminum |  Eustigmin(um, i n
Eustralum |  Eustral(um, i n
Eustrophinum |  Eustrophin(um, i n
Eusynthomycinum |  Eusynthomycin(um, i n
Eutensolum |  Eutensol(um, i n
Euterpe |  Euterpe, es f
Eutizonum |  Eutizon(um, i n
eutrophus |  eutrophus, a, um биолог.
Eutropius |  Eutropius, i m
Euvernilum |  Euvernil(um, i n
evacuatio |  evacuatio, onis f
evado |  evado, vasi, vasum, ere
evagor |  evagor, atus sum, ari воен.
evalesco |  evalesco, valui, --, ere
evanesco |  evanesco, vanui, --, ere
evanidus |  evanidus, a, um
evans |  evans, antis
evasto |  evasto, avi, atum, are
Evazolum |  Evazol(um, i n
eveho |  eveho, vexi, vectum, ere pass.
evello |  evello, evelli (evulsi), evulsum, ere
evenio |  evenio, veni, ventum, ire
eventum |  eventum, i n
eventus |  eventus, us m
everbero |  everbero, avi, atum, are
everriculum |  everriculum, i n
everriculus |  everriculus, i m
everro |  everro, verri, versum, ere
eversio |  eversio, onis f
eversor |  eversor, oris m
everto |  everto (evorto), verti (vorti),versum (vorsum), ere
evestigatus |  evestigatus, a, um
evidens |  evidens, entis
evidenter |  evidenter adv.
evigilo |  evigilo, avi, atum, are
evincio |  evincio, vinxi, vinctum, ire
evinco |  evinco, vici, victum, ere
Evipalum |  Evipal(um, i n
Evipanum |  Evipan(um, i n
eviscero |  eviscero, (avi), atum, are
evitabilis |  evitabilis, e
Evitanum |  Evitan(um, i n
evito |  evito, avi, atum, are
evocati |  evocati, orum m
evocator |  evocator, oris m
evoco |  evoco, avi, atum, are
evoe |  evoe
evolo |  evolo, avi, atum, are
evolsus |  evolsus, a, um см.
evolutio |  evolutio, onis f
evolvo |  evolvo, volvi, volutum, ere
evomo |  evomo, mui, mitum, ere
evorto |  evorto, vorti, vorsum, ere
Evramycinum |  Evramycin(um, i n
evulgo |  evulgo, avi, atum, are
ex |  ex praep.
exacerbo |  exacerbo, avi, atum, are
Exacthinum |  Exacthin(um, i n
exactio |  exactio, onis f
exactor |  exactor, oris m
exactus |  exactus, a, um
exacuo |  exacuo, acui, acutum, ere
exadversum |  exadversum praep.
exadversus |  exadversus
exaedifico |  exaedifico, avi, atum, are
exaequatio |  exaequatio, onis f
exaequo |  exaequo, avi, atum, are
exaestuo |  exaestuo, avi, atum, are
exaggero |  exaggero, avi, atum, are
exagito |  exagito, avi, atum, are
exalbesco |  exalbesco, bui, --, ere
exalo |  exalo, avi, atum, are
examen |  examen, inis n
examino |  examino, avi, atum, are
Exangitum |  Exangit(um, i n
exanimis |  exanimis, e
exanimo |  exanimo, avi, atum, are pass.
exanimus |  exanimus, a, um
exanthema |  exanthema, atis n
exardesco |  exardesco, arsi, arsum, ere
exaresco |  exaresco, arui, --, ere
exaro |  exaro, avi, atum, are
exaspero |  exaspero, avi, atum, are pass.
exauctoro |  exauctoro, avi, atum, are
exaudio |  exaudio, ivi, itum, ire
exauguratio |  exauguratio, onis f
exauguro |  exauguro, --, --, are
excaeco |  excaeco, avi, atum, are
excanto |  excanto, avi, atum, are
excavatio |  excavatio, onis f
excavatus |  excavatus, a, um анат.
excavo |  excavo, avi, atum, are
excedo |  excedo, cessi, cessum, ere
excellens |  excellens, entis
excellenter |  excellenter adv.
excellentia |  excellentia, ae f
excello |  excello, --, --, ere
excelsum |  excelsum, i n
excelsus |  excelsus, a, um
exceptio |  exceptio, onis f
excepto |  excepto, --, --, are
excerno |  excerno, crevi, cretum, ere
excerpo |  excerpo, cerpsi, cerptum, ere
excessus |  excessus, us m
excetra |  excetra, ae f
excidium |  excidium, i n
excido |  I excido, cidi, --, ere
excieo |  excieo, civi, citum, ere
excindo |  excindo
excio |  excio, civi, citum, ire pass.
excipio |  excipio, cepi, ceptum, ere
excisio |  excisio, onis f
excitatus |  excitatus, a, um
excito |  excito, avi, atum, are юр.
exclamatio |  exclamatio, onis f
exclamo |  exclamo, avi, atum, are
excludo |  excludo, clusi, clusum, ere
excogito |  excogito, avi, atum, are
excolo |  excolo, colui, cultum, ere
excoquo |  excoquo, coxi, coctum, ere
excors |  excors, ordis
excreo |  excreo
excretorius |  excretorius, a, um анат.
excretum |  excretum, i n
excrucio |  excrucio, avi, atum, are
excubiae |  excubiae, arum f
excubitor |  excubitor, oris m
excubo |  excubo, bui, bitum, are
excudo |  excudo, cudi, cusum, ere
exculco |  exculco, --, --, are
excurro |  excurro, cucurri (curri), cursum, ere
excursio |  excursio, onis f
excursor |  excursor, oris m
excursus |  excursus, us m
excusabilis |  excusabilis, e
excusatio |  excusatio, onis f
excuso |  excuso, avi, atum, are
excutio |  excutio, cussi, cussum, ere
exec |  exec...
exedo |  exedo, edi, esum, ere
exemplar |  exemplar, aris n
exemplum |  exemplum, i n
exeo |  exeo, ii (редко ivi), itum, ire
exeq |  exeq...
exerceo |  exerceo, cui, citum, ere pass.
exercitatio |  exercitatio, onis f
exercitatus |  exercitatus, a, um
exercito |  exercito, avi, atum, are
exercitus |  I exercitus, a, um m
exero |  exero
exfodio |  exfodio, fodi, fossum, ere
exhaered |  exhaered...
exhalatio |  exhalatio, onis f
exhalo |  exhalo (exalo), avi, atum, are поэт.
exhaurio |  exhaurio, hausi, haustum, ire
exheredo |  exheredo, avi, atum, are
exhibeo |  exhibeo, hibui, hibitum, ere юр.
Exhorranum |  Exhorran(um, i n
exhorresco |  exhorresco, horrui, --, ere
exhortor |  exhortor, atus sum, ari
exigo |  exigo, egi, actum, ere поэт.
exigue |  exigue adv.
exiguitas |  exiguitas, atis f
exiguum |  exiguum, i n
exiguus |  exiguus, a, um
exilis |  exilis, e
exilium |  exilium, i n
exim |  exim
eximie |  eximie adv.
eximius |  eximius, a, um
eximo |  eximo, emi, emptum, ere
exin |  exin
exinanio |  exinanio, ivi, itum, ire
exinde |  exinde (exin, exim) adv.
existimatio |  existimatio, onis f
existimator |  existimator, oris m
existimo |  existimo (existumo), avi, atum, are
exitiabilis |  exitiabilis (exitialis), e
exitialis |  exitialis, e
exitiosus |  exitiosus, a, um
exitium |  exitium, i n
exitus |  exitus, us m
exlex |  exlex, legis
exocarpium |  exocarpium, i n
exodium |  exodium, i n
exogenus |  exogenus, a, um биолог.
exolesco |  exolesco, levi, letum, ere
exoletus |  exoletus, a, um
exonero |  exonero, avi, atum, are
exophthalmus |  exophthalmus, i m
exoptatus |  exoptatus, a, um
exopto |  exopto, avi, atum, are
exorabilis |  exorabilis, e
exordior |  exordior, orsus sum, iri
exordium |  exordium, i n
exorior |  exorior, ortus sum, iri
exorno |  exorno, avi, atum, are
exoro |  exoro, avi, atum, are pass.
exorsa |  exorsa, orum n
exorsus |  exorsus, us m
exortus |  exortus, us m
exostosis |  exostosis, is f
exostra |  exostra, ae f
exosus |  exosus, a, um
expallesco |  expallesco, pallui, --, ere
Expandexum |  Expandex(um, i n
expavesco |  expavesco, pavi, --, ere
expect |  expect...
expedio |  expedio, ivi (ii), itum, ire воен.
expeditio |  expeditio, onis f
expeditus |  expeditus, a, um
expello |  expello, puli, pulsum, ere
expendo |  expendo, pendi, pensum, ere
expergefacio |  expergefacio, feci, factum, ere
expergiscor |  expergiscor, perrectus sum, pergisci
experiens |  experiens, entis
experientia |  experientia, ae f
experimentum |  experimentum, i n
experior |  experior, pertus sum, iri юр.
expers |  expers, pertis
expertus |  expertus, a, um
expetendus |  expetendus, a, um
expeto |  expeto, ivi, itum, ere
expiatio |  expiatio, onis f
expilatio |  expilatio, onis f
expilo |  expilo, avi, atum, are
expio |  expio, avi, atum, are
expiscor |  expiscor, atus sum, ari
explanatio |  explanatio, onis f
explendesco |  explendesco
expleo |  expleo, plevi, pletum, ere воен.
expletus |  expletus, a, um
explicatio |  explicatio, onis f
explicatus |  explicatus, a, um
explicitior |  explicitior, ius compar.
explico |  explico, avi (ui), atum (itum), are воен.
explodo |  explodo, plosi, plosum, ere
explorator |  explorator, oris m
exploratus |  exploratus, a, um
exploro |  exploro, avi, atum, are
expono |  expono, posui, positum, ere
exportatio |  exportatio, onis f
exporto |  exporto, avi, atum, are
exposco |  exposco, poposci, --, ere
expositus |  expositus, a, um
expostulatio |  expostulatio, onis f
expresse |  expresse adv.
expressus |  expressus, a, um
exprimo |  exprimo, pressi, pressum, ere
exprobratio |  exprobratio, onis f
exprobro |  exprobro, avi, atum, are
expromo |  expromo, prompsi, promptum, ere поэт.
expugnabilis |  expugnabilis, e
expugnatio |  expugnatio, onis f
expugnator |  expugnator, oris m
expugnax |  expugnax, acis
expugno |  expugno, avi, atum, are
expulsio |  expulsio, onis f
expulsor |  expulsor, oris f
expurgo |  expurgo, avi, atum, are поэт.
expustulo |  expustulo, avi, atum, are
exputo |  exputo, avi, atum, are
exquiro |  exquiro, quisivi, quisitum, ere
exquisitus |  exquisitus, a, um
exsaevio |  exsaevio, --, --, ire
exsanguis |  exsanguis, e
exsatio |  exsatio, avi, atum, are
exsaturabilis |  exsaturabilis, e
exsaturo |  exsaturo, avi, atum, are
exsce |  exsce...
exscindo |  exscindo (excindo), scidi, scissum, ere
exscreo |  exscreo, avi, atum, are
exscribo |  exscribo, scripsi, scriptum, ere
exsculpo |  exsculpo, sculpsi, sculptum, ere
exseco |  exseco (exsico, exico), secui, sectum, are
exsecrabilis |  exsecrabilis, e
exsecratio |  exsecratio, onis f
exsecror |  exsecror, atus sum, ari
exsectio |  exsectio, onis f
exsequiae |  exsequiae, arum f
exsequialis |  exsequialis, e
exsequor |  exsequor, cutus (quutus) sum, sequi
exsero |  exsero, serui, sertum, ere
exserto |  exserto, --, --, are
exsibilo |  exsibilo, avi, atum, are
exsicco |  exsicco, avi, atum, are
exsico |  exsico, --, --, are
exsigno |  exsigno, avi, atum, are
exsilio |  exsilio (exilio), silivi (silui), sultum, ire
exsilium |  exsilium, i n
exsisto |  exsisto, stiti (titi), --, ere
exsolvo |  exsolvo, solvi, solutum, ere
exsomnis |  exsomnis, e
exsorbeo |  exsorbeo, bui, --, ere
exsors |  exsors, sortis
exspatior |  exspatior, atus sum, ari
exspectatio |  exspectatio, onis f
exspectatus |  exspectatus, a, um
exspecto |  exspecto, avi, atum, are
exspes |  exspes adj.
exspiro |  exspiro, avi, atum, are
exsplendesco |  exsplendesco, dui, --, ere
exspollo |  exspollo, avi, atum, are
exspuo |  exspuo, spui, sputum, ere
exsterno |  exsterno, avi, atum, are pass.
exstimulo |  exstimulo, avi, atum, are
exstinctor |  exstinctor, oris m
exstinguo |  exstinguo, stinxi, stinctum, ere pass.
exstirpatio |  exstirpatio, onis f
exstirpo |  exstirpo, avi, atum, are
exsto |  exsto (), --, --, are
exstructio |  exstructio, onis f
exstruo |  exstruo, truxi, tructum, ere
exsudativus |  exsudativus, a, um мед.
exsudo |  exsudo, avi, atum, are
exsul |  exsul, ulis m
exsulo |  exsulo, avi, atum, are
exsultatio |  exsultatio, onis f
exsultim |  exsultim adv.
exsulto |  exsulto, avi, atum, are
exsuperabilis |  exsuperabilis, e
exsupero |  exsupero, avi, atum, are поэт.
exsurdo |  exsurdo, --, atum, are
exsurgo |  exsurgo, surrexi, surrectum, ere
exsuscito |  exsuscito, avi, atum, are
exta |  exta, orum n
extemplo |  extemplo adv.
extendo |  extendo, tendi, tensum (tentum), ere воен.
extensio |  extensio, onis f
extensor |  extensor, oris m
extensorius |  extensorius, a, um анат.
extensus |  extensus, a, um
extentus |  extentus, a, um
extenuo |  extenuo, avi, atum, are воен.
exter |  exter (exterus), era, erum
extergeo |  extergeo, tersi, tersum, ere
exterior |  exterior, ius compar.
extermino |  extermino, avi, atum, are
externa |  externa, orum n
externus |  I externus, a, um m
extero |  extero, trivi, tritum, ere
exterreo |  exterreo, terrui, territum, ere
exterus |  exterus, a, um
extimesco |  extimesco, timui, --, ere
extimus |  extimus (extumus), a, um
extin- |  extin...
exto |  exto, --, --, are
extollo |  extollo, extuli, --, ere
extorqueo |  extorqueo, torsi, tortum, ere
extorris |  extorris, e
extra |  I extra adv.
extrabuccalis |  extrabuccalis, e анат.
extracapsularis |  extracapsularis, e анат.
extracardialis |  extracardialis, e анат.
extracellularis |  extracellularis, e биолог.
extractum |  extractum, i n
extracysticus |  extracysticus, a, um анат.
extraduralis |  extraduralis, e анат.
extrahepaticus |  extrahepaticus, a, um анат.
extraho |  extraho, traxi, tractum, ere
extramedullaris |  extramedullaris, e анат.
extramuralis |  extramuralis, e анат.
extraneus |  extraneus, a, um
extranuclearis |  extranuclearis, e биолог.
extraordinarius |  extraordinarius, a, um воен.
extraorganicus |  extraorganicus, a, um анат.
extrapulmonalis |  extrapulmonalis, e анат.
extrapyramidalis |  extrapyramidalis, e анат.
extrauterinus |  extrauterinus, a, um анат.
extremitas |  extremitas, atis f
extremo |  extremo adv.
extremum |  I extremum adv.
extremus |  extremus, a, um superl.
extrico |  extrico, avi, atum, are
extrinsecus |  extrinsecus adv.
extrudo |  extrudo, trusi, trusum, ere
extundo |  extundo, tudi, --, ere
exturbo |  exturbo, avi, atum, are
exubero |  exubero, avi, atum, are
exul |  exul
exulcero |  exulcero, avi, atum, are
exulo |  exulo
exult |  exult...
exululo |  exululo, avi, atum, are
exuo |  exuo, ui, utum, ere воен.
exuro |  exuro, ussi, ustum, ere
exuviae |  exuviae, arum f
