iambeus |  iambeus, a, um
iambus |  iambus, i m
Iapetus |  Iapetus, i m
Iason | Iason, onis m
iaspis |  iaspis, idis f
Iastilum |  Iastil(um, i n
Iber |  Iber...
ibi |  ibi adv.
Ibioxylum |  Ibioxyl(um, i n
ibis |  ibis (is f
ibiscum |  ibiscum
Ibycus |  Ibycus, i m
Icaria |  Icaria, ae f
Icarus |  Icarus, i m
iccirco |  iccirco
Ichthamum |  Ichtham(um, i n
Ichthyolatus |  Ichthyolatus, a, um
Ichthyolum |  Ichthyol(um, i n
Ichthyopanum |  Ichthyopan(um, i n
Ichthyosulfolum |  Ichthyosulfol(um, i n
icio |  icio (ico), ici, ictum, ere
icterus |  icterus, i m
ictus |  ictus, us m
Ida |  Ida, ae f
idcirco |  idcirco (iccirco) adv.
idem |  idem, eadem, idem
identidem |  identidem adv.
ideo |  ideo adv.
Idexurum |  Idexur(um, i n
idiota |  idiota, ae m
idoneus |  idoneus, a, um
Idorutinum |  Idorutin(um, i n
Idoxuridinum |  Idoxuridin(um, i n
Idrianolum |  Idrianol(um, i n
Idrilum |  Idril(um, i n
Idumaea |  Idumaea, ae f
Iduridinum |  Iduridin(um, i n
idus |  idus, uum f
Iduviranum |  Iduviran(um, i n
igitur |  igitur adv.
ignarus |  ignarus, a, um
ignave |  ignave adv.
ignavia |  ignavia, ae f
ignaviter |  ignaviter
ignavus |  ignavus, a, um
ignesco |  ignesco, --, --, ere поэт.
igneus |  igneus, a, um поэт.
igniculus |  igniculus, i m
ignifer |  ignifer, era, erum
ignigena |  ignigena, ae m
ignipes |  ignipes, edis
ignipotens |  ignipotens, entis
ignis |  ignis, is m
ignitus |  ignitus, a, um
ignobilis |  ignobilis, e
ignobilitas |  ignobilitas, atis f
ignominia |  ignominia, ae f
ignominiosus |  ignominiosus, a, um
ignorantia |  ignorantia, ae f
ignoratio |  ignoratio, onis f
ignoratus |  ignoratus, a, um
ignoro |  ignoro, avi, atum, are
ignosco |  ignosco, novi, notum, ere
ignotus |  I ignotus, a, um part.
IHS |  IHS сокр. от
II |  II сокр. от
IIS |  IIS сокр. от
ileum |  ileum, i n
ileus |  ileus, a, um анат.
ilex |  ilex, icis f
Ilia |  I Ilia, ae f
iliacus |  iliacus, a, um анат.
Ilias |  Ilias, adis f
ilicet |  ilicet adv.
ilico |  ilico (illico) adv.
ilignus |  ilignus, a, um
iliocecalis |  iliocecalis, e анат.
iliococcygeus |  iliococcygeus, a, um анат.
iliocolicus |  iliocolicus, a, um анат.
iliocostalis |  iliocostalis, e анат.
iliofemoralis |  iliofemoralis, e анат.
iliohypogastricus |  iliohypogastricus, a, um анат.
ilioinguinalis |  ilioinguinalis, e анат.
iliolumbalis |  iliolumbalis, e анат.
Ilion |  Ilion (Ilium), i n
iliopectineus |  iliopectineus, a, um анат.
iliopsoas |  iliopsoas m
iliopubicus |  iliopubicus, a, um анат.
iliosacralis |  iliosacralis, e анат.
iliotibialis |  iliotibialis, e анат.
illa |  illa adv.
illabefactus |  illabefactus, a, um
illabor |  illabor, lapsus sum, labi
illac |  illac adv
illacrimabilis |  illacrimabilis, e
illacrimo |  illacrimo, avi, atum, are
illacrimor |  illacrimor, atus sum, ari
illaesus |  illaesus, a, um
illaetabilis |  illaetabilis, e
illaqueo |  illaqueo, avi, atum, are
illaudatus |  illaudatus, a, um
illautus |  illautus, a, um
ille |  ille, illa, illud gen.
illecebra |  illecebra, ae f
illectus |  I illectus, a, um part.
illepide |  illepide adv.
illibatus |  illibatus, a, um
illiberalis |  illiberalis, e
illiberalitas |  illiberalitas, atis f
illic |  illic adv
illicio |  illicio, lexi, lectum, ere
illicitus |  illicitus, a, um
illico |  illico adv.
illido |  illido, lisi, lisum, ere
illigo |  illigo, avi, atum, are
illim |  illim adv.
illimis |  illimis, e
illinc |  illinc adv.
illino |  illino, levi, litum, ere
illitteratus |  illitteratus, a, um
illo |  illo adv.
illotus |  illotus, a, um
illuc |  illuc adv.
illucesco |  illucesco (illucisco), luxi, --, ere impers.
illucisco |  illucisco), luxi, --, ere
illudo |  illudo, lusi, lusum, ere
illustris |  illustris, e
illustro |  illustro, avi, atum, are
illutus |  illutus, a, um
illuvies |  illuvies, ei f
Illyria |  Illyria, ae f
Ilotycinum |  Ilotycin(um, i n
Iludrinum |  Iludrin(um, i n
Imadilum |  Imadil(um, i n
imaginarius |  imaginarius, a, um
imaginor |  imaginor, atus sum, ari
imago |  imago, inis f
Imagonum |  Imagon(um, i n
Imaninum |  Imanin(um, i n
imbecillitas |  imbecillitas, atis f
imbecillius |  imbecillius adv.
imbecillus |  imbecillus, a, um
imbellis |  imbellis, e
imber |  imber, bris m
imberbis |  imberbis, e
imberbus |  imberbus, a, um
imbibo |  imbibo, bibi, --, ere
imbrex |  imbrex, icis m
imbrifer |  imbrifer, era, erum
imbuo |  imbuo, bui, butum, ere поэт.
Imidinum |  Imidin(um, i n
Imidoum |  Imido(um, i n
Imiphosum |  Imiphos(um, i n
Imipramilum |  Imipramil(um, i n
Imipraminum |  Imipramin(um, i n
imitabilis |  imitabilis, e
imitamen |  imitamen, inis n
imitamentum |  imitamentum, i n
imitatio |  imitatio, onis f
imitator |  imitator, oris m
imitatrix |  imitatrix, icis f
imitor |  imitor, atus sum, ari поэт.
Imizinum |  Imizin(um, i n
immadesco |  immadesco, madui, --, ere
immane |  immane adv.
immanis |  immanis, e
immanitas |  immanitas, atis f
immansuetus |  immansuetus, a, um
immaturitas |  immaturitas, atis f
immaturus |  immaturus, a, um
immedicabilis |  immedicabilis, e
immemor |  immemor, oris
immemoratus |  immemoratus, a, um
immensum |  I immensum, i n
immensus |  immensus, a, um
immerens |  immerens, entis
immergo |  immergo, mersi, mersum, ere
immerito |  immerito adv.
immeritus |  immeritus, a, um
immersabilis |  immersabilis, e
immetatus |  immetatus, a, um
immigro |  immigro, avi, atum, are
immineo |  immineo, --, --, ere
imminuo |  imminuo, nui, nutum, ere
imminutio |  imminutio, onis f
immisceo |  immisceo, miscui, mixtum (mistum), ere pass.
immiserabilis |  immiserabilis, e
immissio |  immissio, onis f
immissus |  immissus, a, um
immitis |  immitis, e
immitto |  immitto, misi, missum, ere
immo |  immo (imo) adv.
immobilis |  immobilis, e
immoderate |  immoderate adv.
immoderatio |  immoderatio, onis f
immoderatus |  immoderatus, a, um
immodeste |  immodeste adv.
immodestia |  immodestia, ae f
immodestus |  immodestus, a, um
immodice |  immodice adv.
immodicus |  immodicus, a, um
immodulatus |  immodulatus, a, um
immolitus |  immolitus, a, um
immolo |  immolo, avi, atum, are поэт.
immorior |  immorior, mortuus sum, mori
immorsus |  immorsus, a, um
immortalis |  immortalis, e
immortalitas |  immortalitas, atis f
immotus |  immotus, a, um
immugio |  immugio, ii, --, ire
immulgeo |  immulgeo, --, --, ere
immundus |  immundus, a, um
immunis |  immunis, e
immunitas |  immunitas, atis f
immunitus |  immunitus, a, um
immurmuro |  immurmuro, (avi), atum, are
immutabilis |  immutabilis, e
immutatio |  immutatio, onis f
immutatus |  I immutatus, a, um part.
immutilatus |  immutilatus, a, um
immuto |  immuto, avi, atum, are
imo |  imo
IMP. |  IMP. сокр. от
impacatus |  impacatus, a, um
impar |  impar, aris
imparatus |  imparatus, a, um
impariter |  impariter adv.
impartio |  impartio
impastus |  impastus, a, um
impatiens |  impatiens, entis
impavide |  impavide adv.
impavidus |  impavidus, a, um
impedimentum |  impedimentum, i n
impedio |  impedio, ivi (ii), itum, ire поэт.
impeditio |  impeditio, onis f
impeditus |  impeditus, a, um воен.
impello |  impello, puli, pulsum, ere
impendeo |  impendeo, --, --, ere
impendio |  impendio adv.
impendium |  impendium, i n
impendo |  impendo, pendi, pensum, ere
impenetrabilis |  impenetrabilis, e
impensa |  impensa, ae f
impense |  impense adv.
impensus |  impensus, a, um
imperativus |  imperativus, i m
imperator |  imperator, oris m
imperatorius |  imperatorius, a, um
imperatrix |  imperatrix, icis f
imperatum |  imperatum, i n
imperceptus |  imperceptus, a, um
impercussus |  impercussus, a, um
imperditus |  imperditus, a, um
imperfectus |  imperfectus, a, um
imperfossus |  imperfossus, a, um
imperiosus |  imperiosus, a, um
imperite |  imperite adv.
imperitia |  imperitia, ae f
imperito |  imperito, avi, atum, are
imperitus |  imperitus, a, um
imperium |  imperium, i n
imperjuratus |  imperjuratus, a, um
impermissus |  impermissus, a, um
impero |  impero, avi, atum, are юр.
imperterritus |  imperterritus, a, um
impertio |  impertio, ivi (ii), itum, ire
imperturbatus |  imperturbatus, a, um
impervius |  impervius, a, um
impes |  impes, etis m
impetrabilis |  impetrabilis, e
impetrio |  impetrio, ivi, itum, ire
impetro |  impetro, avi, atum, are
impetus |  impetus, us m
impexus |  impexus, a, um
impie |  impie adv.
impietas |  impietas, atis f
impiger |  impiger, gra, grum
impingo |  impingo, pegi, pactum, ere
impius |  impius, a, um
implacabilis |  implacabilis, e
implacatus |  implacatus, a, um
implacidus |  implacidus, a, um
implantatio |  implantatio, onis f
implecto |  implecto, plexi, plexum, ere
impleo |  impleo, plevi, pletum, ere
implicatio |  implicatio, onis f
implicatus |  implicatus, a, um
implico |  implico, ui (avi), itum (atum), are pass.
imploratio |  imploratio, onis f
imploro |  imploro, avi, atum, are
implumis |  implumis, e
impluo |  impluo, plui, --, ere
impluvium |  impluvium, i n
impolitus |  impolitus, a, um
impollutus |  impollutus, a, um
impono |  impono, posui, positum, ere
importo |  importo, avi, atum, are
importunitas |  importunitas, atis f
importunus |  importunus, a, um
importuosus |  importuosus, a, um
impotens |  impotens, entis
impotenter |  impotenter adv.
impotentia |  impotentia, ae f
IMPP |  IMPP сокр. от
impraesentiarum |  impraesentiarum adv.
impransus |  impransus, a, um
imprecor |  imprecor, atus sum, ari
impressio |  impressio, onis f
imprimis |  imprimis adv.
imprimo |  imprimo, pressi, pressum, ere
improbatio |  improbatio, onis f
improbe |  improbe adv.
improbitas |  improbitas, atis f
improbo |  improbo, avi, atum, are
improbus |  improbus, a, um
impromptus |  impromptus, a, um
improperatus |  improperatus, a, um
improvide |  improvide adv.
improvidus |  improvidus, a, um
improviso |  improviso adv.
improvisus |  improvisus, a, um
imprudens |  imprudens, entis
imprudenter |  imprudenter adv
imprudentia |  imprudentia, ae f
impubes |  impubes, eris
impubis |  impubis, e
impudens |  impudens, entis
impudenter |  impudenter adv.
impudentia |  impudentia, ae f
impudicitia |  impudicitia, ae f
impudicus |  impudicus, a, um
impugno |  impugno, avi, atum, are
impulsor |  impulsor, oris m
impulsus |  impulsus, us m
impune |  impune adv
impunitas |  impunitas, atis f
impunitus |  impunitus, a, um
impure |  impure adv.
impuritas |  impuritas, atis f
impurus |  impurus, a, um
imputatus |  I imputatus, a, um part.
imputo |  imputo, avi, atum, are
Imuranum |  Imuran(um, i n
Imurelum |  Imurel(um, i n
imus |  imus, a, um superl.
in |  in praep.
inaccessus |  inaccessus, a, um
inacesco |  inacesco, acui, --, ere
Inachus |  Inachus, i m
inadsuetus |  inadsuetus, a, um
inadustus |  inadustus, a, um
inaedifico |  inaedifico, avi, atum, are
inaequabilis |  inaequabilis, e
inaequalis |  inaequalis, e поэт.
inaequaliter |  inaequaliter adv.
inaequo |  inaequo, --, --, are
inaestimabilis |  inaestimabilis, e
inaestuo |  inaestuo, --, --, are
Inalpini |  Inalpini, orum m
inamabilis |  inamabilis, e
inamaresco |  inamaresco, --, --, ere
inambitiosus |  inambitiosus, a, um
inambulo |  inambulo, avi, --, are
inamoenus |  inamoenus, a, um
inane |  inane, is n
inanimalis |  inanimalis, e
inanimus |  inanimus, a, um
inanis |  inanis, e
inaniter |  inaniter adv.
Inapsinum |  Inapsin(um, i n
inaratus |  inaratus, a, um
inardesco |  inardesco, arsi, --, ere
inassuetus |  inassuetus, a, um
inattenuatus |  inattenuatus, a, um
inaudax |  inaudax, acis
inauditus |  inauditus, a, um
inaugaro |  inaugaro, avi, atum, are
inauro |  inauro, avi, atum, are
inauspicato |  inauspicato adv.
inauspicatus |  inauspicatus, a, um
inausus |  inausus, a, um
inb |  inb...
incaeduus |  incaeduus, a, um
incalesco |  incalesco, calui, --, ere
incalfacio |  incalfacio, --, --, ere
incallidus |  incallidus, a, um
incandesco |  incandesco, candui, --, ere
incanesco |  incanesco, nui, --, ere
incantatus |  incantatus, a, um
incanus |  incanus, a, um
incastigatus |  incastigatus, a, um
incaute |  incaute adv.
incautus |  incautus, a, um
incedo |  incedo, cessi, cessum, ere воен.
incelebratus |  incelebratus, a, um
incendium |  incendium, i n
incendo |  incendo, cendi, censum, ere
incensio |  incensio, onis f
incensus |  I incensus, a, um part.
inceptum |  inceptum, i n
inceptus |  inceptus, us m
incertum |  incertum, i n
incertus |  incertus, a, um поэт.
incesso |  incesso, cessivi (cessi), --, ere
incessus |  incessus, us m
inceste |  inceste adv.
incesto |  incesto, --, --, are
incestum |  incestum, i n
incestus |  I incestus, a, um m
inchoatus |  inchoatus, a, um
inchoo |  inchoo (incoho), avi, atum, are
Incidalum |  Incidal(um, i n
incido |  I incido, cidi, --, ere impers.
incingo |  incingo, cinxi, cinctum, ere
incipio |  incipio, cepi, ceptum, ere
incisivus |  I incisivus, a, um анат.
incisura |  incisura, ae f
incitamentum |  incitamentum, i n
incitatio |  incitatio, onis f
incitatus |  incitatus, a, um
incito |  incito, avi, atum, are pass.
incitus |  incitus, a, um
inclamo |  inclamo, avi, atum, are
inclemens |  inclemens, entis
inclementer |  inclementer adv.
inclementia |  inclementia, ae f
inclinatio |  inclinatio, onis f
inclinatus |  inclinatus, a, um
inclino |  inclino, avi, atum, are pass.
inclitus |  inclitus
includo |  includo, clusi, clusum, ere
inclusio |  inclusio, onis f
inclutus |  inclutus (inclytus, inclitus), a, um
incogito |  incogito, --, --, are
incognita |  incognita, orum n
incognitus |  incognitus, a, um
incoho |  incoho, avi, atum, are
incola |  incola, ae m
incolo |  incolo, colui, cultum, ere
incolomis |  incolomis, e
incolumis |  incolumis (incolomis), e
incolumitas |  incolumitas, atis f
incomitatus |  incomitatus, a, um
incommendatus |  incommendatus, a, um
incommode |  incommode adv.
incommoditas |  incommoditas, atis f
incommodo |  incommodo, avi, atum, are
incommodum |  incommodum, i n
incommodus |  incommodus, a, um
incompertus |  incompertus, a, um
incompletus |  incompletus, a, um мед.
incomposite |  incomposite adv.
incompositus |  incompositus, a, um
incomptus |  incomptus, a, um
inconcessus |  inconcessus, a, um
inconcinnus |  inconcinnus, a, um
incondicionalis |  incondicionalis, e
inconditus |  inconditus, a, um
inconsideratus |  inconsideratus, a, um
inconsolabilis |  inconsolabilis, e
inconstans |  inconstans, antis
inconstanter |  inconstanter adv.
inconstantia |  inconstantia, ae f
inconsulte |  inconsulte (inconsulto) adv.
inconsultus |  inconsultus, a, um
inconsumptus |  inconsumptus, a, um
incontaminatus |  incontaminatus, a, um
incontinens |  incontinens, entis
incontinentia |  incontinentia, ae f
incoquo |  incoquo, coxi, coctum, ere
Incoranum |  Incoran(um, i n
incorrectus |  incorrectus, a, um
incorrupte |  incorrupte adv.
incorruptus |  incorruptus, a, um
Incortenum |  Incorten(um, i n
increbesco |  increbesco, bui, --, ere
increbresco |  increbresco (increbesco), brui (bui), --, ere
incredibilis |  incredibilis, e
incredibiliter |  incredibiliter adv.
incredulus |  incredulus, a, um
incrementum |  incrementum, i n
Increpanum |  Increpan(um, i n
increpito |  increpito, avi, atum, are
increpo |  increpo, ui (avi), atum (itum), are
incresco |  incresco, crevi, --, ere
incruentatus |  incruentatus, a, um
incruentus |  incruentus, a, um
incrusto |  incrusto, avi, atum, are
incubo |  incubo, avi (ui), atum (itum), are
incudo |  incudo, cusus, --, ere
incudomallearis |  incudomallearis, e анат.
incudostapedius |  incudostapedius, a, um анат.
inculco |  inculco, avi, atum, are
inculpatus |  inculpatus, a, um
inculte |  inculte adv.
incultus |  I incultus, a, um m
incumbo |  incumbo, cubui, cubitum, ere
incunabula |  incunabula, orum n
incuratus |  incuratus, a, um
incuria |  incuria, ae f
incuriose |  incuriose adv.
incuriosus |  incuriosus, a, um
incurro |  incurro, curri (cucurri), cursum, ere
incursio |  incursio, onis f
incurso |  incurso, avi, atum, are
incursus |  incursus, us m
incurvo |  incurvo, avi, atum, are
incurvus |  incurvus, a, um
incus |  incus, udis f
incuso |  incuso, avi, atum, are
incustoditus |  incustoditus, a, um
incutio |  incutio, cussi, cussum, ere
Indacinum |  Indacin(um, i n
indago |  I indago, avi, atum, are f
inde |  inde adv.
indebitus |  indebitus, a, um
indeclinatus |  indeclinatus, a, um
indecore |  indecore adv.
indecoris |  indecoris, e
indecoro |  indecoro, --, --, are
indecorus |  indecorus, a, um
indefensus |  indefensus, a, um
indefessus |  indefessus, a, um
indefletus |  indefletus, a, um
indejectus |  indejectus, a, um
indelebilis |  indelebilis, e
indelibatus |  indelibatus, a, um
indemnatus |  indemnatus, a, um
indeploratus |  indeploratus, a, um
indeprensus |  indeprensus, a, um
Inderalum |  Inderal(um, i n
indesertus |  indesertus, a, um
indestrictus |  indestrictus, a, um
indetonsus |  indetonsus, a, um
indevitatus |  indevitatus, a, um
index |  index, icis m
indicativus |  indicativus, i m
indicens |  I indicens, entis part.
indicium |  indicium, i n
indico |  I indico, avi, atum, are
indictus |  I indictus, a, um поэт.
indidem |  indidem adv.
indifferens |  indifferens, entis
indigena |  indigena, ae m
indigens |  indigens, entis
indigentia |  indigentia, ae f
indigenus |  indigenus, a, um
indigeo |  indigeo, gui, --, ere
indiges |  I indiges, etis m
indigestus |  indigestus, a, um
indignabundus |  indignabundus, a, um
indignandus |  indignandus, a, um
indignans |  indignans, antis
indignatio |  indignatio, onis f
indigne |  indigne adv.
indignitas |  indignitas, atis f
indignor |  indignor, atus sum, ari
indignus |  indignus, a, um
Indigocarminum |  Indigocarmin(um, i n
indigus |  indigus, a, um
indiligens |  indiligens, entis
indiligenter |  indiligenter adv.
indiligentia |  indiligentia, ae f
indipiscor |  indipiscor, deptus sum, dipisci
indiscretus |  indiscretus, a, um
individuum |  individuum, i n
individuus |  individuus, a, um
indo |  indo, didi, ditum, ere
Indocidum |  Indocid(um, i n
indocilis |  indocilis, e поэт.
indoctus |  I indoctus, a, um поэт.
indoles |  indoles, is f
indolesco |  indolesco, dolui, --, ere
indomitus |  indomitus, a, um
Indopanum |  Indopan(um, i n
indormio |  indormio, ivi, itum, ire
indotatus |  indotatus, a, um
indu |  indu арх.
indubitatus |  indubitatus, a, um
indubito |  indubito, --, --, are
indubius |  indubius, a, um
induciae |  induciae, arum f
induco |  induco, duxi, ductum, ere
inductio |  inductio, onis f
inductus |  I inductus, a, um m
indulgens |  indulgens, entis
indulgenter |  indulgenter adv.
indulgentia |  indulgentia, ae f
indulgeo |  indulgeo, dulsi, dultum, ere
induo |  induo, dui, dutum, ere
induresco |  induresco, durui, --, ere
induro |  induro, avi, atum, are
indusium |  indusium, i n
industria |  industria, ae f
industrie |  industrie adv.
industrius |  industrius, a, um
indutiae |  indutiae, arum f
inedia |  inedia, ae f
ineditus |  ineditus, a, um
ineluctabilis |  ineluctabilis, e
inemorior |  inemorior, --, emori
inemptus |  inemptus (inemtus), a, um
inemtus |  inemtus, a, um
inenarrabilis |  inenarrabilis, e
ineo |  ineo, ii (редко ivi), itum, ire
inepte |  inepte adv.
ineptia |  ineptia, ae f
ineptus |  ineptus, a, um
inermis |  inermis, e
inermus |  inermus, a, um
iners |  iners, ertis поэт.
inertia |  inertia, ae f
ineruditus |  ineruditus, a, um
inesco |  inesco, avi, atum, are
inevectus |  inevectus, a, um
inevitabilis |  inevitabilis, e
inexcitus |  inexcitus, a, um
inexcusabilis |  inexcusabilis, e
inexcussus |  inexcussus, a, um
inexercitatus |  inexercitatus, a, um
inexhaustus |  inexhaustus, a, um
inexorabilis |  inexorabilis, e
inexpectatus |  inexpectatus
inexpeditus |  inexpeditus, a, um
inexperrectus |  inexperrectus, a, um
inexpertus |  inexpertus, a, um
inexpiabilis |  inexpiabilis, e
inexplebilis |  inexplebilis, e
inexpletus |  inexpletus, a, um
inexplicabilis |  inexplicabilis, e
inexploratus |  inexploratus, a, um
inexpugnabilis |  inexpugnabilis, e
inexspectatus |  inexspectatus, a, um
inexstinctus |  inexstinctus, a, um
inexsuperabilis |  inexsuperabilis, e
inextricabilis |  inextricabilis, e
infabre |  infabre adv.
infabricatus |  infabricatus, a, um
infacetus |  infacetus
infacundus |  infacundus, a, um
Infadinum |  Infadin(um, i n
infamia |  infamia, ae f
infamis |  infamis, e
infamo |  infamo, avi, atum, are
infanda |  infanda, orum n
infandus |  infandus, a, um
infans |  I infans, antis поэт.
infantia |  infantia, ae f
infarctus |  infarctus, us m
infatuo |  infatuo, avi, atum, are
infaustus |  infaustus, a, um
infectiosus |  infectiosus, a, um мед.
infectus |  I infectus, a, um part.
Infecundinum |  Infecundin(um, i n
infecunditas |  infecunditas, atis f
infecundus |  infecundus, a, um
infelicitas |  infelicitas, atis f
infelix |  infelix, icis
infense |  infense adv.
infensus |  infensus, a, um
inferiae |  inferiae, arum f
inferior |  inferior, ius compar.
inferius |  inferius adv.
infernus |  infernus, a, um
infero |  infero, intuli, illatum, inferre pass.
inferus |  inferus, a, um compar.
infervesco |  infervesco, ferbui, --, ere
infeste |  infeste adv.
infesto |  infesto, avi, atum, are
infestus |  infestus, a, um воен.
inficet |  inficet...
inficetus |  inficetus, a, um
inficias |  inficias
inficio |  inficio, feci, fectum, ere
inficior |  inficior
infidelis |  infidelis, e
infidelitas |  infidelitas, atis f
infidus |  infidus, a, um
infigo |  infigo, fixi, fixum, ere pass.
infimi |  infimi, orum m
infimus |  infimus (infumus), a, um superl.
infindo |  infindo, fidi, fissum, ere
infinitas |  infinitas, atis f
infinitivus |  infinitivus, a, um
infinitum |  infinitum, i n
infinitus |  infinitus, a, um
infirmatio |  infirmatio, onis f
infirmitas |  infirmitas, atis f
infirmo |  infirmo, avi, atum, are
infirmus |  infirmus, a, um
infit |  infit defect.
infitias |  infitias acc.
infitiatio |  infitiatio, onis f
infitiator |  infitiator, oris m
infitior |  infitior, atus sum, ari
inflammatio |  inflammatio, onis f
inflammo |  inflammo, avi, atum, are
inflatus |  inflatus, a, um
inflecto |  inflecto, flexi, flexum, ere pass.
infletus |  infletus, a, um
infligo |  infligo, flixi, flictum, ere
inflo |  inflo, flavi, flatum, are pass.
influo |  influo, fluxi, fluxum, ere
infodio |  infodio, fodi, fossum, ere
informis |  informis, e
informo |  informo, avi, atum, are
infortunium |  infortunium, i n
infra |  I infra adv.
infraclavicularis |  infraclavicularis, e анат.
infracorticalis |  infracorticalis, e анат.
infragilis |  infragilis, e
infraglenoidalis |  infraglenoidalis, e анат.
infraglotticus |  infraglotticus, a, um анат.
infrahyoideus |  infrahyoideus, a, um анат.
infralobaris |  infralobaris, e анат.
infraorbitalis |  infraorbitalis, e анат.
infrapalpebralis |  infrapalpebralis, e анат.
infrapatellaris |  infrapatellaris, e анат.
infrapiriformis |  infrapiriformis, e анат.
infrascapularis |  infrascapularis, e анат.
infrasegmentalis |  infrasegmentalis, e анат.
infraspinalis |  infraspinalis, e анат.
infraspinatus |  infraspinatus, a, um анат.
infrasternalis |  infrasternalis, e анат.
infratemporalis |  infratemporalis, e анат.
infratrochlearis |  infratrochlearis, e анат.
infraumbilicalis |  infraumbilicalis, e анат.
infremo |  infremo, ui, --, ere
infrenatus |  I infrenatus, a, um part.
infrendo |  infrendo, --, --, ere
infrenis |  infrenis, e
infreno |  infreno, avi, atum, are
infrenus |  infrenus, a, um
infrequens |  infrequens, entis
infrequentia |  infrequentia, ae f
infringo |  infringo, fregi, fractum, ere
infrons |  infrons, frondis
infula |  infula, ae f
infumus |  infumus, a, um
infundibularis |  infundibularis, e анат.
infundibulum |  infundibulum, i n
infundo |  infundo, fudi, fusum, ere pass.
infusco |  infusco, avi, atum, are
infusum |  infusum, i n
ingemino |  ingemino, avi, atum, are
ingemisco |  ingemisco, gemui, --, ere
ingemo |  ingemo, gemui, --, ere
ingeneratus |  ingeneratus, a, um
ingenero |  ingenero, avi, atum, are
ingeniosus |  ingeniosus, a, um
ingenium |  ingenium, i n
ingenius |  ingenius, a, um
ingens |  ingens, entis
ingenuitas |  ingenuitas, atis f
ingenuus |  ingenuus, a, um
ingero |  ingero, gessi, gestum, ere
ingigno |  ingigno, genui, genitum, ere
inglorius |  inglorius, a, um
ingluvies |  ingluvies, ei f
ingrate |  ingrate adv.
ingratificus |  ingratificus, a, um
ingratiis |  ingratiis adv.
ingratus |  ingratus, a, um
ingravesco |  ingravesco, --, --, ere
ingravo |  ingravo, avi, atum, are
ingredior |  ingredior, gressus sum, gredi
ingressio |  ingressio, onis f
ingressus |  ingressus, us m
ingruo |  ingruo, grui, --, ere
inguen |  inguen, inis n
inguinalis |  inguinalis, e анат.
ingurgito |  ingurgito, avi, --, are
ingustatus |  ingustatus, a, um
inhabilis |  inhabilis, e
inhabitabilis |  inhabitabilis, e
inhabito |  inhabito, avi, atum, are
inhaereo |  inhaereo, haesi, haesum, ere
inhaeresco |  inhaeresco, haesi, haesum, ere
Inhalanum |  Inhalan(um, i n
inhalo |  inhalo, avi, --, are
Inhalyptum |  Inhalypt(um, i n
inhibens |  inhibens, entis
inhibeo |  inhibeo, bui, bitum, ere
inhio |  inhio, avi, atum, are
inhonesto |  inhonesto, --, --, are
inhonestus |  inhonestus, a, um
inhonoratus |  inhonoratus, a, um
inhonorus |  inhonorus, a, um
inhorreo |  inhorreo, --, --, ere
inhorresco |  inhorresco, horrui, --, ere
inhospitalis |  inhospitalis, e
inhospitus |  inhospitus, a, um
inhumane |  inhumane adv.
inhumanitas |  inhumanitas, atis f
inhumaniter |  inhumaniter adv.
inhumanus |  inhumanus, a, um
inhumatus |  inhumatus, a, um
inibi |  inibi adv.
inicio |  inicio
inicus |  inicus, a, um
inimice |  inimice adv.
inimicitia |  inimicitia, ae f
inimico |  inimico, avi, atum, are
inimicus |  I inimicus, a, um поэт.
inique |  inique adv.
iniqui |  iniqui, orum m
iniquitas |  iniquitas, atis f
iniquus |  iniquus (inicus), a, um
initio |  initio, avi, atum, are
initium |  initium, i n
initus |  initus, us m
injectio |  injectio, onis f
injicio |  injicio (в  praes.
injucundus |  injucundus, a, um
injungo |  injungo, junxi, junctum, ere
injuratus |  injuratus, a, um
injuria |  injuria, ae f
injuriose |  injuriose adv.
injuriosus |  injuriosus, a, um
injurius |  injurius, a, um
injussu |  injussu abl.
injussus |  injussus, a, um
injuste |  injuste adv.
injustitia |  injustitia, ae f
injustum |  injustum, i n
injustus |  injustus, a, um
inl |  inl...
inm |  inm...
innabilis |  innabilis, e
innascor |  innascor, natus sum, nasci
innato |  innato, avi, atum, are
innatus |  innatus, a, um
innavigabilis |  innavigabilis, e
innecto |  innecto, nexui, nexum, ere
innervatio |  innervatio, onis f
innitor |  innitor, nixus (nisus) sum, niti
inno |  inno, avi, atum, are
innocens |  innocens, entis
innocentia |  innocentia, ae f
innocue |  innocue adv.
innocuus |  innocuus, a, um
innominatus |  innominatus, a, um анат.
innotesco |  innotesco, notui, --, ere
innovo |  innovo, avi, --, are
innoxius |  innoxius, a, um
innubo |  innubo, nupsi, --, ere
innubus |  innubus, a, um
innumerabilis |  innumerabilis, e
innumerus |  innumerus, a, um
innuo |  innuo, nui, --, ere
innuptae |  innuptae, arum f
innuptus |  innuptus, a, um
inoblitus |  inoblitus, a, um
inobrutus |  inobrutus, a, um
inobservatus |  inobservatus, a, um
inodorus |  inodorus, a, um биолог.
inoffensus |  inoffensus, a, um
inofficiosus |  inofficiosus, a, um
inolesco |  inolesco, olevi, --, ere
inominatus |  inominatus, a, um
Inonotus |  Inonotus, i m
inopia |  inopia, ae f
inopinans |  inopinans, antis
inopinato |  inopinato adv.
inopinatum |  inopinatum, i n
inopinatus |  inopinatus, a, um
inopinus |  inopinus, a, um
inops |  inops, opis
inoratus |  inoratus, a, um
inordinatus |  inordinatus, a, um
inornatus |  inornatus, a, um поэт.
inp |  inp...
inquam |  inquam defect.
inquies |  inquies, etis
inquieto |  inquieto, avi, atum, are
inquietus |  inquietus, a, um
inquilinus |  inquilinus, i m
inquinatus |  inquinatus, a, um
inquino |  inquino, avi, atum, are
inquiro |  inquiro, quisivi, quisitum, ere
inquisitio |  inquisitio, onis f
inquisitor |  inquisitor, oris m
inr |  inr...
insalutatus |  insalutatus, a, um
insanabilis |  insanabilis, e
insane |  insane adv.
insania |  insania, ae f
insanio |  insanio, ivi (ii), itum, ire
insanus |  insanus, a, um
insatiabilis |  insatiabilis, e
insaturabilis |  insaturabilis, e
insciens |  insciens, entis
inscienter |  inscienter adv.
inscientia |  inscientia, ae f
inscite |  inscite adv.
inscitia |  inscitia, ae f
inscitus |  inscitus, a, um
inscius |  inscius, a, um
inscribo |  inscribo, scripsi, scriptum, ere
inscriptio |  inscriptio, onis f
insculpo |  insculpo, sculpsi, sculptum, ere
inseco |  inseco, secui, sectum, are
insectatio |  insectatio, onis f
insectator |  insectator, oris m
insectivorum |  insectivorum, i n
insectivorus |  insectivorus, a, um биолог.
insector |  insector, atus sum, ari
insectum |  insectum, i n
insenesco |  insenesco, senui, --, ere
insepultus |  insepultus, a, um
insequor |  insequor, secutus (sequutus) sum, sequi
insero |  I insero, serui, sertum, ere
insertio |  insertio, onis f
inserto |  inserto, avi, atum, are
inservio |  inservio, ivi, itum, ire
insibilo |  insibilo, --, --, are
insideo |  insideo, sedi, sessum, ere
insidiae |  insidiae, arum f
insidiator |  insidiator, oris m
insidior |  insidior, atus sum, ari
insidiose |  insidiose adv.
insidiosus |  insidiosus, a, um
insido |  insido, sedi, sessum, ere
insigne |  insigne, is n
insignio |  insignio, ivi, itum, ire
insignis |  insignis, e
insignite |  insignite adv.
insigniter |  insigniter
insignitus |  I insignitus, a, um part.
insilio |  insilio, silui, sultum, ire
insimulatio |  insimulatio, onis f
insimulo |  insimulo, avi, atum, are
insincerus |  insincerus, a, um
insinuo |  insinuo, avi, atum, are
insipidus |  insipidus, a, um мед.
insipiens |  insipiens, entis
insisto |  insisto, stiti, --, ere
insitio |  insitio, onis f
insitivus |  insitivus, a, um
insociabilis |  insociabilis, e
insolabiliter |  insolabiliter adv.
insolens |  insolens, entis
insolenter |  insolenter adv.
insolentia |  insolentia, ae f
insolesco |  insolesco, --, --, ere
insolidus |  insolidus, a, um
insolitus |  insolitus, a, um pass.
insomnia |  insomnia, ae f
insomnis |  insomnis, e
insomnium |  insomnium, i n
insono |  insono, sonui, sonitum, are
insons |  insons, sontis
insopitus |  insopitus, a, um
inspecto |  inspecto, avi, atum, are
insperans |  insperans, antis
insperatus |  insperatus, a, um
inspergo |  inspergo, spersi, spersum, ere
inspicio |  inspicio, spexi, spectum, ere
inspico |  inspico, --, --, are
inspiro |  inspiro, avi, atum, are
inspoliatus |  inspoliatus, a, um
instabilis |  instabilis, e
instans |  I instans, antis n
instar |  I instar n
instauratio |  instauratio, onis f
instauro |  instauro, avi, atum, are
insterno |  insterno, stravi, stratum, ere
instigo |  instigo, avi, atum, are
instillo |  instillo, avi, atum, are
instimulator |  instimulator, oris m
instimulo |  instimulo, --, --, are
instinctus |  instinctus, a, um
instita |  instita, ae f
institor |  institor, oris m
instituo |  instituo, tui, tutum, ere
institutum |  institutum, i n
insto |  insto, stiti, --, are
instratus |  instratus, a, um
instrepo |  instrepo, --, --, ere
instructio |  instructio, onis f
instructius |  instructius adv.
instructor |  instructor, oris m
instructus |  instructus, a, um
instrumentum |  instrumentum, i n
instruo |  instruo, struxi, structum, ere
insuavis |  insuavis, e
insudo |  insudo, --, -- are
insuefactus |  insuefactus, a, um
insuesco |  insuesco, suevi, suetum, ere
insueta |  insueta adv.
insuetus |  I insuetus, a, um part.
insufficientia |  insufficientia, ae f
insula |  insula, ae f
Insulinum |  Insulin(um, i n
insulsitas |  insulsitas, atis f
insulsus |  insulsus, a, um
insulto |  insulto, avi, atum, are
insultus |  insultus, us m
insum |  insum, fui, --, esse
insumo |  insumo, sumpsi, sumptum, ere
insuo |  insuo, sui, sutum, ere поэт.
insuper |  insuper adv.
insuperabilis |  insuperabilis, e
insurgo |  insurgo, surrexi, surrectum, ere
insusurro |  insusurro, avi, atum, are
intabesco |  intabesco, tabui, --, ere
intactus |  intactus, a, um
intaminatus |  intaminatus, a, um
Intebanum |  Inteban(um, i n
intectus |  intectus, a, um
integer |  integer, gra, grum поэт.
integumentum |  integumentum, i n
Intencordinum |  Intencordin(um, i n
Intensacromum |  Intensacrom(um, i n
Intensainum |  Intensain(um, i n
Intensolum |  Intensol(um, i n
intentio |  intentio, onis f
intepesco |  intepesco, tepui, --, ere
inter |  inter praep.
interalveolaris |  interalveolaris, e анат.
interamenta |  interamenta, orum n
interannularis |  interannularis, e анат.
interarcualis |  interarcualis, e анат.
interarticularis |  interarticularis, e анат.
interarytenoideus |  interarytenoideus, a, um анат.
interatrialis |  interatrialis, e анат.
Intercainum |  Intercain(um, i n
intercalaris |  intercalaris, e анат.
intercalarius |  intercalarius, a, um
intercalatus |  intercalatus, a, um анат.
intercalo |  intercalo, avi, atum, are
intercapitalis |  intercapitalis, e анат.
intercarpeus |  intercarpeus, a, um анат.
intercartilagineus |  intercartilagineus, a, um анат.
intercavernosus |  intercavernosus, a, um анат.
intercedo |  intercedo, cessi, cessum, ere
intercellularis |  intercellularis, e анат.
interceptio |  interceptio, onis f
interceptor |  interceptor, oris m
intercessio |  intercessio, onis f
intercessor |  intercessor, oris m
interchondralis |  interchondralis, e анат.
intercido |  I intercido, cidi, --, ere pass.
intercino |  intercino, --, --, ere
intercipio |  intercipio, cepi, ceptum, ere
interclavicularis |  interclavicularis, e анат.
intercludo |  intercludo, clusi, clusum, ere
intercolumnaris |  intercolumnaris, e анат.
intercolumnium |  intercolumnium, i n
intercondylaris |  intercondylaris, e анат.
intercostalis |  intercostalis, e анат.
intercostobrachialis |  intercostobrachialis, e анат.
intercruralis |  intercruralis, e анат.
intercuneiformis |  intercuneiformis, e анат.
intercurro |  intercurro, cucurri (curri), cursum, ere
intercurso |  intercurso, --, --, are
intercursus |  intercursus, us m
interdico |  interdico, dixi, dictum, ere юр.
interdictio |  interdictio, onis f
interdictum |  interdictum, i n
interdiu |  interdiu adv.
interdum |  interdum. adv.
interea |  interea adv.
intereo |  intereo, ii, itum, ire
interequito |  interequito, --, --, are
interfatio |  interfatio, onis f
interfector |  interfector, oris m
interficio |  interficio, feci, fectum, ere
interfluo |  interfluo, fluxi, fluxum, ere
interfor |  interfor, fatus sum, ari
interfoveolaris |  interfoveolaris, e анат.
interfusus |  interfusus, a, um
interglobularis |  interglobularis, e анат.
intergyralis |  intergyralis, e анат.
interhemisphericus |  interhemisphericus, a, um анат.
interhyoideus |  interhyoideus, a, um анат.
interim |  interim adv.
interimo |  interimo, emi, emptum (emtum), ere
interior |  I interior, ius compar.
interitio |  interitio, onis f
interitus |  interitus, us m
interius |  interius adj.
interjaceo |  interjaceo, --, --, ere
interjacio |  interjacio, jeci, jectum, ere
interjicio |  interjicio (interjacio), jeci, jectum, ere
interjungo |  interjungo, junxi, junctum, ere
Interkellinum |  Interkellin(um, i n
interlabor |  interlabor, --, labi
interlacunaris |  interlacunaris, e анат.
interlego |  interlego, --, --, ere
interlino |  interlino, levi, litum, ere
interlobaris |  interlobaris, e анат.
interlobularis |  interlobularis, e анат.
interluceo |  interluceo, luxi, --, ere impers.
interlunium |  interlunium, i n
interluo |  interluo, --, --, ere поэт.
intermaxillaris |  intermaxillaris, e анат.
intermediolateralis |  intermediolateralis, e анат.
intermediomedialis |  intermediomedialis, e анат.
intermedius |  intermedius, a, um анат.
intermembranaceus |  intermembranaceus, a, um анат.
intermeningealis |  intermeningealis, e анат.
intermenstruum |  intermenstruum, i n
intermenstruus |  intermenstruus, a, um
intermetacarpalis |  intermetacarpalis, e анат.
intermetacarpeus |  intermetacarpeus, a, um анат.
interminor |  interminor, atus sum, ari
intermisceo |  intermisceo, miscui, mistum (mixtum), ere
intermissio |  intermissio, onis f
intermitto |  intermitto, misi, missum, ere pass.
intermorior |  intermorior, mortuus sum, mori
intermuratis |  intermuratis, e
intermuscularis |  intermuscularis, e анат.
internasalis |  internasalis, e анат.
internascor |  internascor, natus sum, nasci
internecinus |  internecinus
internecio |  internecio (internicio), onis f
internecivus |  internecivus, a, um
internecto |  internecto, --, --, ere
internicio |  internicio, onis f
internodium |  internodium, i n
internosco |  internosco, novi, notum, ere
internuntio |  internuntio, --, --, are
internuntius |  internuntius, i m
internus |  internus, a, um
interolateralis |  interolateralis, e анат.
interosseus |  interosseus, a, um анат.
interparietalis |  interparietalis, e анат.
interpeduncularis |  interpeduncularis, e анат.
interpellatio |  interpellatio, onis f
interpello |  interpello, avi, atum, are
interphalangeus |  interphalangeus, a, um анат.
Interphanum |  Interphan(um, i n
interpolaris |  interpolaris, e анат.
interpolo |  interpolo, avi, atum, are
interpono |  interpono, posui, positum, ere pass.
interpres |  interpres, etis m
interpretatio |  interpretatio, onis f
interpretor |  interpretor, atus sum, ari
interpubicus |  interpubicus, a, um анат.
interpunctio |  interpunctio, onis f
interpungo |  interpungo, punxi, punctum, ere
interradicularis |  interradicularis, e анат.
interregnum |  interregnum, i n
interrex |  interrex, regis m
interritus |  interritus, a, um
interrogatio |  interrogatio, onis f
interrogo |  interrogo, avi, atum, are юр.
interrumpo |  interrumpo, rupi, ruptum, ere
intersacralis |  intersacralis, e анат.
intersaepio |  intersaepio, saepsi, saeptum, ire
interscapularis |  interscapularis, e анат.
interscindo |  interscindo, scidi, scissum, ere
intersectio |  intersectio, onis f
intersegmentalis |  intersegmentalis, e анат.
intersepio |  intersepio
intersero |  intersero, serui, sertum, ere
intersigmoideus |  intersigmoideus, a, um анат.
interspecificus |  interspecificus, a, um биолог.
interspinalis |  interspinalis, e анат.
interstitialis |  interstitialis, e анат.
interstitium |  interstitium, i n
interstrepo |  interstrepo, --, --, ere
intersum |  intersum, fui, --, esse impers.
intersystemicus |  intersystemicus, a, um анат.
intertendineus |  intertendineus, a, um анат.
intertexo |  intertexo, texui, textum, ere
interthalamicus |  interthalamicus, a, um анат.
intertragicus |  intertragicus, a, um анат.
intertransversarius |  intertransversarius, a, um анат.
intertrimentum |  intertrimentum, i n
intertrochantericus |  intertrochantericus, a, um анат.
intertubercularis |  intertubercularis, e анат.
interuretericus |  interuretericus, a, um анат.
intervallum |  intervallum, i n
intervenio |  intervenio, veni, ventum, ire
interventricularis |  interventricularis, e анат.
interventus |  interventus, us m
intervertebralis |  intervertebralis, e анат.
interverto |  interverto (intervorto), verti (vorti), versum (vorsum), ere
intervolito |  intervolito, --, --, are
intervorto |  intervorto, vorti, vorsum, ere
intestabilis |  intestabilis, e
intestatus |  intestatus, a, um
intestinalis |  intestinalis, e анат.
intestinum |  intestinum, i m
intestinus |  intestinus, a, um
Intestopanum |  Intestopan(um, i n
intexo |  intexo, texui, textum, ere
intibum |  intibum (intybum, intubum), i n
intima |  intima, ae f
intime |  intime adv.
intimus |  intimus, a, um superl.
intingo |  intingo (intinguo), tinxi, tinctum, ere
intinguo |  intinguo, tinxi, tinctum, ere
intolerabilis |  intolerabilis, e
intolerandus |  intolerandus, a, um
intolerans |  intolerans, antis
intoleranter |  intoleranter adv.
intolerantia |  intolerantia, ae f
intono |  intono, tonui, tonatum, are
intonsus |  intonsus, a, um
intorqueo |  intorqueo, torsi, tortum, ere
intra |  I intra adv.
intraabdominalis |  intraabdominalis, e анат.
intraarterialis |  intraarterialis, e анат.
intraarticularis |  intraarticularis, e анат.
intraatrialis |  intraatrialis, e анат.
intrabilis |  intrabilis, e
Intrabilixum |  Intrabilix(um, i n
intrabronchialis |  intrabronchialis, e анат.
intracapsularis |  intracapsularis, e анат.
intracardialis |  intracardialis, e анат.
intracarpalis |  intracarpalis, e анат.
intracellularis |  intracellularis, e биолог.
intracerebellaris |  intracerebellaris, e анат.
intracerebralis |  intracerebralis, e анат.
Intracortum |  Intracort(um, i n
intracranialis |  intracranialis, e анат.
intractabilis |  intractabilis, e
intractatus |  intractatus (intrectatus), a, um
intracutaneus |  intracutaneus, a, um анат.
intraduralis |  intraduralis, e анат.
intrafascicularis |  intrafascicularis, e анат.
intraglandularis |  intraglandularis, e анат.
Intraiodum |  Intraiod(um, i n
intrajugularis |  intrajugularis, e анат.
intralaryngealis |  intralaryngealis, e анат.
intralobaris |  intralobaris, e анат.
intralobularis |  intralobularis, e анат.
Intramedullaris |  Intramedullaris, e анат.
intrameningealis |  intrameningealis, e анат.
intramuralis |  intramuralis, e анат.
intramuscularis |  intramuscularis, e анат.
intraoccipitalis |  intraoccipitalis, e анат.
intraocularis |  intraocularis, e анат.
intraorganicus |  intraorganicus, a, um анат.
intrapleuralis |  intrapleuralis, e анат.
intrasegmentalis |  intrasegmentalis, e анат.
intraspecificus |  intraspecificus, a, um биолог.
intrasystemicus |  intrasystemicus, a, um анат.
intrathecalis |  intrathecalis, e анат.
intrathoracalis |  intrathoracalis, e анат.
intrauterinalis |  intrauterinalis, e анат.
Intravalum |  Intraval(um, i n
intravascularis |  intravascularis, e мед.
intravenosus |  intravenosus, a, um анат.
intraventricularis |  intraventricularis, e анат.
intrectatus |  intrectatus, a, um
intremisco |  intremisco, tremui, --, ere
intremo |  intremo, --, --, ere
intrepide |  intrepide adv.
intrepidus |  intrepidus, a, um
intritus |  I intritus, a, um part.
intro |  I intro adv.
introduco |  introduco, duxi, ductum, ere
introeo |  introeo, ivi (ii), itum, ire
introfero |  introfero, tuli, --, ferre
introgredior |  introgredior, gressus sum, gredi
introitus |  introitus, us m
intromitto |  intromitto, misi, missum, ere
introrsum |  introrsum adv.
introrsus |  introrsus
introrumpo |  introrumpo, rupi, ruptum, ere
introspicio |  introspicio, spexi, spectum, ere
intubum |  intubum, i n
intubus |  intubus, i m
intueor |  intueor, tuitus sum, eri
intumescentia |  intumescentia, ae f
intumesco |  intumesco, tumui, --, ere
intumulatus |  intumulatus, a, um
intuor |  intuor, --, tui
intus |  intus adv.
intutus |  intutus, a, um
intybum |  intybum, i n
intybus |  intybus, i m
inula |  inula, ae f
inultus |  inultus, a, um поэт.
inumbro |  inumbro, avi, atum, are
inundatio |  inundatio, onis f
inundo |  inundo, avi, atum, are
inungo |  inungo (inunguo), unxi, unctum, ere
inunguo |  inunguo, unxi, unctum, ere
inurbanus |  inurbanus, a, um
inuro |  inuro, ussi, ustum, ere
inusitatus |  inusitatus, a, um
inutilis |  inutilis, e
inutilitas |  inutilitas, atis f
inutiliter |  inutiliter adv.
invado |  invado, vasi, vasum, ere
invalidus |  invalidus, a, um
Invasinum |  Invasin(um, i n
invectio |  invectio, onis f
inveho |  inveho, vexi, vectum, ere pass.
invenio |  invenio, veni, ventum, ire
Invenolum |  Invenol(um, i n
inventio |  inventio, onis f
inventor |  inventor, oris m
inventrix |  inventrix, icis f
inventum |  inventum, i n
inverecundus |  inverecundus, a, um
invergo |  invergo, --, --, ere
inversus |  inversus, a, um анат.
inverto |  inverto, verti, versum, ere
invesperascit |  invesperascit, --, --, ere impers.
investigator |  investigator, oris m
investigo |  investigo, avi, atum, are
inveterasco |  inveterasco, ravi, --, ere
inveteratus |  inveteratus, a, um
invetero |  invetero, avi, atum, are pass.
invicem |  invicem (также раздельно in vicem),
invictus |  invictus, a, um
invidatus |  invidatus, a, um
invidentia |  invidentia, ae f
invideo |  invideo, vidi, visum, ere
invidia |  invidia, ae f
invidiose |  invidiose adv.
invidiosus |  invidiosus, a, um
invidus |  invidus, a, um
invigilo |  invigilo, avi, atum, are
inviolabilis |  inviolabilis, e
invisitatus |  invisitatus, a, um
inviso |  inviso, visi, visum, ere
invisus |  I invisus, a, um поэт.
invitamentum |  invitamentum, i n
invitatio |  invitatio, onis f
invito |  invito, avi, atum, are
invitus |  invitus, a, um
invius |  invius, a, um
invocatus |  I invocatus, a, um part.
invoco |  invoco, avi, atum, are
involito |  involito, avi, atum, are
involo |  involo, avi, atum, are
involucrum |  involucrum, i n
involutus |  involutus, a, um
involvo |  involvo, volvi, volutum, ere
invulneratus |  invulneratus, a, um
io |  I io! interj.
Iochinolum |  Iochinol(um, i n
Iodatolum |  Iodatol(um, i n
Iodglobinum |  Iodglobin(um, i n
Iodgorgonum |  Iodgorgon(um, i n
Iodidum |  Iodid(um, i n
Iodinolum |  Iodinol(um, i n
Iodipamidum |  Iodipamid(um, i n
Iodipinum |  Iodipin(um, i n
Iodobilanum |  Iodobilan(um, i n
Iodobilum |  Iodobil(um, i n
Iodochlorhydroxyquinum |  Iodochlorhydroxyquin(um, i n
Iodocillina |  Iodocillina, ae f
Iodoformium |  Iodoformi(um, i n
Iodognostum |  Iodognost(um, i n
Iodoleinum |  Iodolein(um, i n
Iodolipolum |  Iodolipol(um, i n
Iodonatum |  Iodonat(um, i n
Iodopyracetum |  Iodopyracet(um, i n
Iodtriolum |  Iodtriol(um, i n
Iodum |  Iodum, i n
Ioduronum |  Ioduron(um, i n
Iofendilatum |  Iofendilat(um, i n
Iones |  Iones, um m
Iopagnostum |  Iopagnost(um, i n
Iopanum |  Iopan(um, i n
iota |  iota n
Ipecacuanha |  Ipecacuanha, ae f
Iphigenia |  Iphigenia, ae f
Ipnolanum |  Ipnolan(um, i n
Ipnosedum |  Ipnosed(um, i n
Ipoctalum |  Ipoctal(um, i n
Ipoguaninum |  Ipoguanin(um, i n
Iprazidum |  Iprazid(um, i n
Iproniazidum |  Iproniazid(um, i n
Ipronidum |  Ipronid(um, i n
Iproninum |  Ipronin(um, i n
Iproveratrilum |  Iproveratril(um, i n
ipse |  ipse, a, um gen.
ira |  ira, ae f
iracunde |  iracunde adv.
iracundia |  iracundia, ae f
iracundus |  iracundus, a, um
irascor |  irascor, --, irasci
iratus |  iratus, a, um
Irgapyrinum |  Irgapyrin(um, i n
iridicus |  iridicus, a, um анат.
iridocornealis |  iridocornealis, e анат.
Iridozinum |  Iridozin(um, i n
Iris |  I Iris, idis f
Irminum |  Irmin(um, i n
Iroquinum |  Iroquin(um, i n
irregularis |  irregularis, e
irreligatus |  irreligatus, a, um
irreligiosus |  irreligiosus, a, um
irremeabilis |  irremeabilis, e
irreparabilis |  irreparabilis, e
irrepertus |  irrepertus, a, um
irrepo |  irrepo, repsi, reptum, ere
irreprehensus |  irreprehensus, a, um
irrequietus |  irrequietus, a, um
irresectus |  irresectus, a, um
irresolutus |  irresolutus, a, um
irretio |  irretio, ivi, itum, ire
irretortus |  irretortus, a, um
irrevocabilis |  irrevocabilis, e
irrevocatus |  irrevocatus, a, um
irrideo |  irrideo, risi, risum, ere
irridicule |  irridicule adv.
irrigatio |  irrigatio, onis f
irrigo |  irrigo, avi, atum, are поэт.
irriguus |  irriguus, a, um
irrisio |  irrisio, onis f
irrisor |  irrisor, oris m
irrisus |  irrisus, us m
irritabilis |  irritabilis, e
irritamen |  irritamen, inis n
irritamentum |  irritamentum, i n
irritatio |  irritatio, onis f
irrito |  irrito, avi, atum, are
irritus |  irritus, a, um
irrogatio |  irrogatio, onis f
irrogo |  irrogo, avi, atum, are
irroro |  irroro, avi, atum, are
irrumpo |  irrumpo, rupi, ruptum, ere
irruo |  irruo, ui, --, ere
irruptio |  irruptio, onis f
irruptus |  irruptus, a, um
is |  is, ea, id
Isadrinum |  Isadrin(um, i n
Isapheninum |  Isaphenin(um, i n
Isarolum |  Isarol(um, i n
Isazenum |  Isazen(um, i n
ischemia |  ischemia, ae f
ischemicus |  ischemicus, a, um мед.
ischiadicus |  ischiadicus, a, um анат.
ischiocavernosus |  ischiocavernosus, a, um анат.
ischiofemoralis |  ischiofemoralis, e анат.
ischiorectalis |  ischiorectalis, e анат.
ischium |  ischium, i n
Iscotinum |  Iscotin(um, i n
Isis |  Isis, is (idis) f
Ismelinum |  Ismelin(um, i n
Ismipurum |  Ismipur(um, i n
Isobarbum |  Isobarb(um, i n
Isobarinum |  Isobarin(um, i n
Isobromylum |  Isobromyl(um, i n
Isobrovalum |  Isobroval(um, i n
Isocainum |  Isocain(um, i n
Isocholum |  Isochol(um, i n
isochronia |  isochronia, ae f
Isocotinum |  Isocotin(um, i n
Isodrenalum |  Isodrenal(um, i n
Isolanidum |  Isolanid(um, i n
Isomilnitritum |  Isomilnitrit(um, i n
Isoneurinum |  Isoneurin(um, i n
Isoniazidum |  Isoniazid(um, i n
Isonicazidum |  Isonicazid(um, i n
Isonicidum |  Isonicid(um, i n
Isonitrosinum |  Isonitrosin(um, i n
Isonorinum |  Isonorin(um, i n
isopetalus |  isopetalus, a, um биолог.
Isophenum |  Isophen(um, i n
Isophrinum |  Isophrin(um, i n
Isophyllinum |  Isophyllin(um, i n
Isoprinum |  Isoprin(um, i n
Isopromedolum |  Isopromedol(um, i n
Isopropylarterenolum |  Isopropylarterenol(um, i n
Isoprotanum |  Isoprotan(um, i n
Isoproterenolum |  Isoproterenol(um, i n
Isoptera |  Isoptera, orum n
Isoptinum |  Isoptin(um, i n
Isopyrastinum |  Isopyrastin(um, i n
Isorbidum |  Isorbid(um, i n
Isoreninum |  Isorenin(um, i n
Isotebezidum |  Isotebezid(um, i n
isotonicus |  isotonicus, a, um
isotransplantatio |  isotransplantatio, onis f
Isovalum |  Isoval(um, i n
Isoverinum |  Isoverin(um, i n
Isoxuprinum |  Isoxuprin(um, i n
Istalum |  Istal(um, i n
iste |  iste, ista, istud gen.
Ister |  Ister, tri m
Isthmus |  I Isthmus (-os), i m
isti |  isti adv.
istic |  I istic, istaec, istoc (istuc) adv.
istinc |  istinc adv.
istiusmodi |  istiusmodi
Istopirinum |  Istopirin(um, i n
Istria |  Istria, ae f
istuc |  istuc (isthuc) adv.
Isuprelum |  Isuprel(um, i n
ita |  ita adv.
Italchinum |  Italchin(um, i n
Italia |  Italia, ae f
itaque |  itaque adv.
item |  item adv.
iter |  iter, itineris n
itero |  itero, avi, atum, are
iterum |  iterum adv.
Ithaca |  Ithaca, ae f
itidem |  itidem adv.
itio |  itio, onis f
ito |  ito, --, --, are
itus |  itus, us m
