labecula |  labecula, ae f
labefacio |  labefacio, feci, factum, ere
labefacto |  labefacto, avi, atum, are pass.
labefio |  labefio, factus sum, fieri pass.
labellum |  I labellum, i n
labes |  labes, is f
labialis |  labialis, e анат.
Labitonum |  Labiton(um, i n
labium |  labium, i n
labo |  labo, avi, atum, are
labor |  I labor, lapsus sum, labi pass.
laborifer |  laborifer, era, erum
laboriose |  laboriose adv.
laboriosus |  laboriosus, a, um
laboro |  laboro, avi, atum, are
labrum |  I labrum, i n
labrusca |  labrusca, ae f
labruscum |  labruscum, i n
labyrinthus |  labyrinthus (-os), i m
lac |  lac, lactis n
Lacaena |  Lacaena, ae f
Lacedaemon |  Lacedaemon, onis f
Lacedaemonius |  Lacedaemonius, a, um
lacer |  lacer, era, erum
laceratio |  laceratio, onis f
lacerna |  lacerna, ae f
lacero |  lacero, avi, atum, are
lacerta |  lacerta, ae f
lacertosus |  lacertosus, a, um
lacertus |  I lacertus, i m
lacesso |  lacesso, ivi (ii), itum, ere
Lachesis |  Lachesis, is f
lacinia |  lacinia, ae f
laciniatus |  laciniatus, a, um анат.
lacinula |  lacinula, ae f
Laco |  Laco, onis m
Laconica |  Laconica, ae f
Laconicus |  Laconicus, a, um
lacrima |  lacrima (lacruma), ae f
lacrimabilis |  lacrimabilis (lacrumabilis), e
lacrimabundus |  lacrimabundus, a, um
lacrimalis |  lacrimalis, e анат.
lacrimo |  lacrimo (lacrumo), avi, atum, are
lacrimoconchalis |  lacrimoconchalis, e анат.
lacrimomaxillaris |  lacrimomaxillaris, e анат.
lacrimosus |  lacrimosus (lacrumusus), a, um
lacrimula |  lacrimula, ae f
lacrum |  lacrum...
lactas |  lactas, atis m
lactens |  lactens, entis adj.
lacteo |  lacteo, --, --, ere
lacteus |  lacteus, a, um
lacticus |  lacticus, a, um
lactifer |  lactifer, era, erum
lacto |  lacto, --, --, are
Lactobenum |  Lactoben(um, i n
Lactofiavinum |  Lactofiavin(um, i n
lactuca |  lactuca, ae f
Lacuminum |  Lacumin(um, i n
lacuna |  lacuna, ae f
lacunar |  lacunar, aris n
lacuno |  lacuno, --, --, are
lacus |  lacus, us m
laedo |  laedo, laesi, laesum, ere
Laemoranum |  Laemoran(um, i n
laena |  laena, ae f
Laerta |  Laerta (Laertes), ae (is) m
Laestrygones |  Laestrygones, um m
laetabilis |  laetabilis, e
laetans |  laetans, antis
laetatio |  laetatio, onis f
laete |  laete adv.
laetitia |  laetitia, ae f
laetor |  laetor, atus sum, ari
laetus |  laetus, a, um
laeva |  I laeva, ae f
laeve |  laeve adv.
laevigo |  laevigo
laevis |  laevis
laevo |  laevo
Laevoiodinum |  Laevoiodin(um, i n
Laevomepromazinum |  Laevomepromazin(um, i n
Laevomycetinum |  Laevomycetin(um, i n
laevor |  laevor
laevum |  laevum, i n
laevus |  laevus, a, um
laganum |  laganum, i n
lagena |  lagena, ae f
lageos |  lageos, ei f
lagoena |  lagoena (lagona, lagena), ae f
lagois |  lagois, idis f
Lagostrophus |  Lagostrophus, i m
Laiades |  Laiades, ae m
Laius |  Laius (Lajus), i m
lama |  lama, ae f
lambdoideus |  lambdoideus, a, um анат.
lambo |  lambo, lambi, lambitum, ere
Lambratenum |  Lambraten(um, i n
lamella |  lamella, ae f
lamellosus |  lamellosus, a, um анат.
lamentabilis |  lamentabilis, e
lamentatio |  lamentatio, onis f
lamentor |  lamentor, atus sum, ari
lamentum |  lamentum, i n
lamia |  lamia, ae f
lamina |  lamina (lamna, lammina, lammna), ae f
Laminaria |  Laminaria, ae f
lammina |  lammina
lammna |  lammna
lamna |  lamna
Lamorylum |  Lamoryl(um, i n
lampadium |  lampadium, i n
lampas |  lampas, adis acc.
lamyrus |  lamyrus, i m
lana |  lana, ae f
Lanacardum |  Lanacard(um, i n
Lanacordalum |  Lanacordal(um, i n
Lanacordinum |  Lanacordin(um, i n
Lanacristum |  Lanacrist(um, i n
lanatus |  lanatus, a, um
lancea |  lancea, ae f
laneus |  laneus, a, um
Langobardi |  Langobardi, orum m
langueo |  langueo, gui, --, ere
languesco |  languesco, langui, --, ere
languide |  languide adv.
languidulus |  languidulus, a, um
languidus |  languidus, a, um
languor |  languor, oris m
lanicium |  lanicium, i n
Lanicorum |  Lanicor(um, i n
laniena |  laniena, ae f
lanificus |  lanificus, a, um
laniger |  laniger, era, erum
lanio |  lanio, avi, atum, are
lanista |  lanista, ae m
lanius |  lanius, i m
Lanolinum |  Lanolin(um, i n
Lanoralum |  Lanoral(um, i n
Lanoxinum |  Lanoxin(um, i n
lanterna |  lanterna (laterna), ae f
lanternarius |  lanternarius, i m
Lantosidum |  Lantosid(um, i n
Lantrolum |  Lantrol(um, i n
lanugo |  lanugo, inis f
Lanuvium |  Lanuvium, i n
lanx |  lanx, lancis f
Laocoon |  Laocoon, ontis m
Laodicea |  Laodicea, ae f
Laomedon |  Laomedon, dontis m
Laomedontiades |  Laomedontiades, ae m
lapathum |  lapathum, i n
lapicida |  lapicida, ae m
lapicidinae |  lapicidinae, arum f
lapidatio |  lapidatio, onis f
lapidator |  lapidator, oris m
lapideus |  lapideus, a, um
lapido |  lapido, avi, atum, are impers.
lapidosus |  lapidosus, a, um
lapillus |  lapillus, i m
lapis |  lapis, idis m
lappa |  lappa, ae f
lapso |  lapso, --, --, are
lapsus |  lapsus, us m
laquear |  laquear, aris n
laqueatus |  laqueatus, a, um
laqueus |  laqueus, i m
lar |  lar, laris n
lardum |  lardum, i n
Largactilum |  Largactil(um, i n
large |  large adv.
largior |  largior, itus sum, iri
largitas |  largitas, atis f
largiter |  largiter adv.
largitio |  largitio, onis f
largitor |  largitor, oris m
largitudo |  largitudo, inis f
largus |  largus, a, um
Larissa |  Larissa (Larisa), ae f
Laristinum |  Laristin(um, i n
Laroscorbinum |  Laroscorbin(um, i n
Larostidinum |  Larostidin(um, i n
Laroxytum |  Laroxyt(um, i n
Larus |  Larus, i m
Larusanum |  Larusan(um, i n
larva |  larva, ae f
laryngeus |  laryngeus, a, um анат.
laryngitis |  laryngitis, idis f
laryngocele |  laryngocele, es f
laryngospasmus |  laryngospasmus, i m
larynx |  larynx, yngis m
lasanum |  lasanum, i n
lascivia |  lascivia, ae f
lascivio |  lascivio, ii, --, ire
lascivus |  lascivus, a, um
Lasilixum |  Lasilix(um, i n
lasiocarpus |  lasiocarpus, a, um биолог.
Lasiorrhinus |  Lasiorrhinus, i m
Lasixum |  Lasix(um, i n
lassiterna |  lassiterna, ae f
lassitudo |  lassitudo, inis f
lasso |  lasso, avi, atum, are
lassus |  lassus, a, um
late |  late adv.
latebra |  latebra, ae f
latebrosus |  latebrosus, a, um
latens |  latens, entis
latenter |  latenter adv.
lateo |  lateo, tui, --, ere
later |  later, eris m
lateralis |  lateralis, e анат.
laterculus |  laterculus, i m
latericium |  latericium, i n
latericius |  latericius, a, um
latern |  latern...
latesco |  latesco, --, --, ere
latex |  latex, icis m
Latibonum |  Latibon(um, i n
latibulum |  latibulum, i n
laticaudus |  laticaudus, a, um биолог.
latifolius |  latifolius, a, um биолог.
Latinienses |  Latinienses, ium m
Latinus |  I Latinus, a, um m
latio |  latio, onis f
latissimus |  latissimus, a, um анат.
latito |  latito, avi, atum, are
latitudo |  latitudo, inis f
Latium |  Latium, i n
Latius |  Latius, a, um
Lato |  Lato, us
Latoius |  I Latoius, a, um m
Latona |  Latona, ae f
lator |  lator, oris m
latrator |  latrator, oris m
latratus |  latratus, us m
latro |  I latro, avi, atum, are m
latrocinium |  latrocinium, i n
latrocinor |  latrocinor, atus sum, ari
latrunculus |  latrunculus, i m
latus |  I latus, a, um part.
laudabilis |  laudabilis, e
Laudanum |  Laudan(um, i n
laudatio |  laudatio, onis f
laudator |  laudator, oris m
laudatrix |  laudatrix, icis f
laudatus |  laudatus, a, um
laudo |  laudo, avi, atum, are
laurea |  laurea, ae f
laureatus |  laureatus, a, um
Laurentum |  Laurentum, i n
laureus |  laureus, a, um
lauriger |  lauriger, era, erum
laurus |  laurus, i f
laus |  laus, laudis f
laute |  laute adv.
lautia |  lautia, orum n
lautumiae |  lautumiae, arum f
lautus |  lautus, a, um
lavacrum |  lavacrum, i n
lavatio |  lavatio, onis f
lavatorium |  lavatorium, i n
Laverna |  Laverna, ae f
Lavinia |  Lavinia, ae f
Lavinium |  Lavinium, i n
lavo |  lavo, lavi, lautum поэт.
Lavorphanum |  Lavorphan(um, i n
laxamentum |  laxamentum, i n
Laxatotum |  Laxatot(um, i n
laxe |  laxe adv
Laxigenum |  Laxigen(um, i n
laxitas |  laxitas, atis f
laxo |  laxo, avi, atum, are
Laxogenum |  Laxogen(um, i n
Laxoinum |  Laxoin(um, i n
Laxolum |  Laxol(um, i n
laxus |  laxus, a, um поэт.
Laxylum |  Laxyl(um, i n
lea |  lea, ae f
leaena |  leaena, ae f
lebes |  lebes, etis m
lectica |  lectica, ae f
lecticarius |  lecticarius, i m
lecticula |  lecticula, ae f
lectio |  lectio, onis f
lectisternium |  lectisternium, i n
lectito |  lectito, avi, atum, are
lector |  lector, oris m
lectulus |  lectulus, i m
lectus |  I lectus, a, um m
Leda |  Leda, ae f
Lederkynum |  Lederkyn(um, i n
legatio |  legatio, onis f
legatum |  legatum, i n
legatus |  legatus, i m
legifer |  legifer, era, erum
legio |  legio, onis f
legionarii |  legionarii, orum m
legionarius |  legionarius, a, um
legitime |  legitime adv.
legitimus |  legitimus, a, um
legiuncula |  legiuncula, ae f
lego |  I lego, avi, atum, are юр.
legumen |  I legumen, inis n
Lemannus |  Leman(n)us, i m
Lembrolum |  Lembrol(um, i n
lembus |  lembus, i m
lemniscatus |  lemniscatus, a, um
lemnisci |  lemnisci, orum m
lemniscus |  lemniscus, i m
Lemnos |  Lemnos (-us), i f
lemures |  lemures, um m
lena |  lena, ae f
Lenbirenum |  Lenbiren(um, i n
lene |  lene adv.
lenimen |  lenimen, inis n
lenio |  lenio, ivi (ii), itum, ire
lenis |  lenis, e
lenitas |  lenitas, atis f
leniter |  leniter adv.
lenitudo |  lenitudo, inis f
leno |  leno, onis m
lenocinium |  lenocinium, i n
lenocinor |  lenocinor, atus sum, ari
lens |  lens, lentis f
lente |  lente adv.
lentesco |  lentesco, --, --, ere
lenticularis |  lenticularis, e анат.
lenticulostriatus |  lenticulostriatus, a, um анат.
lenticulothalamicus |  lenticulothalamicus, a, um анат.
lentiformis |  lentiformis, e анат.
Lentinum |  Lentin(um, i n
lentiscifer |  lentiscifer, era, erum
lentiscus |  lentiscus, i
lentitudo |  lentitudo, inis f
lento |  lento, avi, atum, are
Lentosulfa |  Lentosulfa, ae f
lentus |  lentus, a, um
lenunculus |  lenunculus, i m
leo |  leo, onis m
Leontice |  Leontice, es f
Leontini |  Leontini, orum m
Leonurus |  Leonurus, i f
Leopentalum |  Leopental(um, i n
Leostesinum |  Leostesin(um, i n
lepidocarpus |  lepidocarpus, a, um биолог.
lepidopterus |  lepidopterus, a, um биолог.
lepidus |  I lepidus, a, um m
Lepimidinum |  Lepimidin(um, i n
Lepinalum |  Lepinal(um, i n
Leplosuccinum |  Leplosuccin(um, i n
lepor |  lepor (lepos), oris m
Lepsiralum |  Lepsiral(um, i n
Leptazolum |  Leptazol(um, i n
Leptidrolum |  Leptidrol(um, i n
Leptinotarsa |  Leptinotarsa, ae f
leptodactylus |  leptodactylus, a, um биолог.
leptomeninx |  leptomeninx, ingis f
leptourus |  leptourus, a, um биолог.
lepus |  lepus, oris m
lepusculus |  lepusculus, i m
Lerna |  Lerna, ae f
Lesbias |  Lesbias, adis f
Lesbis |  Lesbis, idis f
Lesbos |  Lesbos, i f
letalia |  letalia, ium n
letalis |  letalis, e
lethargicus |  lethargicus, i m
lethargus |  lethargus, i m
Lethe |  Lethe, es f
Lethidronum |  Lethidron(um, i n
letifer |  letifer, era, erum
leto |  leto, avi, atum, are
letum |  letum, i n
Leucadia |  Leucadia, ae f
leucaspis |  leucaspis, idis f
Leuceranum |  Leuceran(um, i n
leucochilus |  leucochilus, a, um биолог.
leucocytosis |  leucocytosis, is f
leucocyturia |  leucocyturia, ae f
leucocytus |  leucocytus, i m
leucoderma |  leucoderma, atis n
Leucogenum |  Leucogen(um, i n
leucolysis |  leucolysis, is f
leucopenia |  leucopenia, ae f
leucopoesis |  leucopoesis, is f
leucopterus |  leucopterus, a, um биолог.
leucosis |  leucosis, is f
Leuctra |  Leuctra, orum n
Leukeranum |  Leukeran(um, i n
Leukomycinum |  Leukomycin(um, i n
Leukosulfanum |  Leukosulfan(um, i n
Leunervalum |  Leunerval(um, i n
Leupurinum |  Leupurin(um, i n
Leurocristinum |  Leurocristin(um, i n
Leuzea |  Leuzea, ae f
levamen |  levamen, inis n
levamentum |  levamentum, i n
Levarterenolum |  Levarterenol(um, i n
levatio |  levatio, onis f
levator |  levator, oris m
levipes |  levipes, edis
levis |  I levis (laevis), e биолог.
levitas |  levitas, atis f
leviter |  leviter adv.
levo |  I levo (laevo), avi, atum, are
Levophedum |  Levophed(um, i n
Levopromazinum |  Levopromazin(um, i n
Levoreninum |  Levorenin(um, i n
Levorinum |  Levorin(um, i n
Levorphanolum |  Levorphanol(um, i n
Levorphanum |  Levorphan(um, i n
lex |  lex, legis f
libamen |  libamen, inis n
libamentum |  libamentum, i n
libatio |  libatio, onis f
libella |  libella, ae f
libellus |  libellus, i m
libens |  libens (lubens), entis
libenter |  libenter (lubenter) adv.
Libentina |  Libentina, ae f
liber |  I liber, bri m
liber | II liber, era, erum
Libera |  Libera, ae f
Liberalia |  Liberalia, ium n
liberalis |  liberalis, e
liberalitas |  liberalitas, atis f
liberaliter |  liberaliter adv.
liberatio |  liberatio, onis f
liberator |  liberator, oris m
libere |  libere adv.
liberi |  liberi, orum (um) m
libero |  libero, avi, atum, are
liberta |  liberta, ae f
libertas |  libertas, atis f
libertina |  libertina, ae f
libertinus |  libertinus, i m
libertus |  libertus, i m
libet |  libet (lubet), buit (bitum est), ere impers.
Libexinum |  Libexin(um, i n
libidinose |  libidinose adv.
libidinosus |  libidinosus, a, um
libido |  libido (lubido), inis f
libita |  libita, orum n
Libitina |  Libitina, ae f
libo |  libo, avi, atum, are
libra |  libra, ae f
libramentum |  libramentum, i n
librariolus |  librariolus, i m
librarium |  librarium, i n
librarius |  I librarius, a, um m
librator |  librator (libritor), oris m
libratus |  libratus, a, um
librilis |  librilis, e
libritor |  libritor, oris m
Librium |  Librium, i n
libro |  libro, avi, atum, are
libum |  libum, i n
Liburni |  Liburni, orum m
Libya |  Libya, ae f
licens |  licens, entis
licenter |  licenter adv.
licentia |  licentia, ae f
liceo |  liceo, cui, citum, ere
liceor |  liceor, citus sum, eri
licet |  licet, cuit (citum est), ere impers.
Licinius |  Licinius, a, um
licitatio |  licitatio, onis f
licitator |  licitator, oris m
licitus |  licitus, a, um
licium |  licium, i n
lictor |  lictor, oris m
Lidazinum |  Lidazin(um, i n
lien |  lien, enis m
lienalis |  lienalis, e анат.
ligamen |  ligamen, inis n
ligamentosus |  ligamentosus, a, um анат.
ligamentum |  ligamentum, i n
Liger |  Liger, eris m
lignarius |  lignarius, i m
lignatio |  lignatio, onis f
lignator |  lignator, oris m
ligneolus |  ligneolus, a, um
Lignocainum |  Lignocain(um, i n
lignor |  lignor, atus sum, ari
lignum |  lignum, i n
ligo |  I ligo, avi, atum, are m
ligreus |  ligreus, a, um
Ligures |  Ligures, um m
Liguria |  Liguria, ae f
ligurrio |  ligurrio (ligurio), ivi (ii), itum, ire
ligustrum |  ligustrum, i n
Likudenum |  Likuden(um, i n
Liliidae |  Liliidae, arum f
lilium |  lilium, i n
lima |  lima, ae f
Limarsolum |  Limarsol(um, i n
limatus |  limatus, a, um
limbus |  limbus, i m
limen |  limen, inis n
limes |  limes, itis m
limitaneus |  limitaneus, a, um
limitans |  limitans, antis
limnobius |  limnobius, a, um биолог.
limnophilus |  limnophilus, a, um биолог.
limo |  limo, avi, atum, are
limosus |  limosus, a, um
limpha |  limpha, ae f
limus |  I limus, a, um m
Linaetholum |  Linaethol(um, i n
Lincocinum |  Lincocin(um, i n
linea |  linea (linia), ae f
lineamentum |  lineamentum, i n
lineus |  lineus, a, um
Linfolysinum |  Linfolysin(um, i n
lingua |  lingua, ae f
lingualis |  lingualis, e анат.
lingula |  lingula, ae f
lingularis |  lingularis, e анат.
linia |  linia, ae f
liniger |  liniger, era, erum
linimentum |  linimentum, i n
lino |  lino, livi (levi), litum, ere
Linolum |  Linol(um, i n
Linoralum |  Linoral(um, i n
linquo |  linquo, liqui, (lictum), ere pass.
linteatus |  linteatus, a, um
linter |  linter (lunter), tris f
linteum |  linteum, i n
linteus |  linteus, a, um
Lintexum |  Lintex(um, i n
linum |  linum, i n
Liothyroninum |  Liothyronin(um, i n
lipaemia |  lipaemia, ae f
Lipamidum |  Lipamid(um, i n
Lipavlonum |  Lipavlon(um, i n
Liphormonum |  Liphormon(um, i n
lipida |  lipida, orum n
Lipiodolum |  Lipiodol(um, i n
Lipocainum |  Lipocain(um, i n
Lipocerebrinum |  Lipocerebrin(um, i n
Lipoicus |  Lipoicus, a, um хим.
Lipolutinum |  Lipolutin(um, i n
lipoma |  lipoma, atis n
lippio |  lippio, ivi, itum, ire
lippitudo |  lippitudo, inis f
lippus |  lippus, a, um
lipuria |  lipuria, ae f
Liquaeminum |  Liquaemin(um, i n
Liquamarum |  Liquamar(um, i n
liquamen |  liquamen, inis n
Liquatolum |  Liquatol(um, i n
liquefacio |  liquefacio, feci, factum, ere
liquefio |  liquefio, factus sum, fieri pass.
liqueo |  liqueo, liqui (liqui), --, ere
liquesco |  liquesco, licui, --, ere
liquide |  liquide adv.
liquidus |  liquidus, a, um
Liquiritonum |  Liquiriton(um, i n
liquo |  liquo, avi, atum, are
liquor |  I liquor, --, liqui m
lis |  lis, litis f
Litarinum |  Litarin(um, i n
litatio |  litatio, onis f
liter |  liter...
lithiasis |  lithiasis, is f
Lithium |  Lithium, i n
lithophilus |  lithophilus, a, um биолог.
lithophyton |  lithophyton, i n
liticen |  liticen, inis m
litigiosus |  litigiosus, a, um
litigo |  litigo, avi, atum, are
lito |  lito, avi, atum, are
litoreus |  litoreus, a, um
littera |  littera (litera), ae f
litterate |  litterate adv.
litteratus |  litteratus, a, um
litterula |  litterula, ae f
littor |  littor...
littus |  littus, oris n
litura |  litura, ae f
litus |  litus, oris n
lituus |  lituus, i m
liveo |  liveo, --, --, ere
Livia |  Livia, ae f
Liviclimanum |  Livicliman(um, i n
lividus |  lividus, a, um
Livius |  Livius, a, um
livor |  livor, oris m
lixa |  lixa, ae m
Lixinum |  Lixin(um, i n
lobaris |  lobaris, e анат.
Lobesilum |  Lobesil(um, i n
lobularis |  lobularis, e анат.
lobulus |  lobulus, i m
lobus |  lobus, i m
Locacortenum |  Locacorten(um, i n
Localynum |  Localyn(um, i n
locatio |  locatio, onis f
locatum |  locatum, i n
loco |  loco, avi, atum, are
Locortenum |  Locorten(um, i n
Locri |  Locri, orum m
Locris |  Locris, idis (idos) f
loculus |  loculus, i m
locuples |  locuples, etis
locupleto |  locupleto, avi, atum, are
locus |  locus, i m
locusta |  locusta, ae f
logopaedia |  logopaedia, ae f
loligo |  loligo, inis f
lolium |  lolium, i n
lolligo |  lolligo, inis f
Londinium |  Londinium, i n
longaevus |  longaevus, a, um
Longamidum |  Longamid(um, i n
longe |  longe adv.
longicaudatus |  longicaudatus, a, um биолог.
longinquitas |  longinquitas, atis f
longinquus |  longinquus, a, um
longiracemosus |  longiracemosus, a, um биолог.
Longisulium |  Longisuli(um, i n
longitudinalis |  longitudinalis, e анат.
longitudo |  longitudo, inis f
longiusculus |  longiusculus, a, um
longum |  longum adv.
longurius |  longurius, i m
longus |  longus, a, um поэт.
loquacitas |  loquacitas, atis f
loquaciter |  loquaciter adv.
loquax |  loquax, quacis
loquela |  loquela (loquella), ae f
loquor |  loquor, cutus (quutus) sum, loqui
loratus |  loratus, a, um
lordosis |  lordosis, is f
Loretinum |  Loretin(um, i n
lorica |  lorica, ae f
loricatus |  loricatus, a, um
loricula |  loricula, ae f
Lorindenum |  Lorinden(um, i n
lorum |  lorum, i n
Lotophagi |  Lotophagi, orum (um) m
lotos |  lotos (-us), i f
lotus |  I lotus, a, um part.
Loxodonta |  Loxodonta, ae f
lubens |  lubens, entis
lubenter |  lubenter
Lubentina |  Lubentina, ae f
lubet |  lubet, buit (bitum est), ere
Lubomycinum |  Lubomycin(um, i n
lubricoideus |  lubricoideus, a, um биолог.
lubricus |  lubricus, a, um
Luca |  Luca, ae f
Lucanus |  Lucanus, i m
luce |  luce adv.
lucellum |  lucellum, i n
luceo |  luceo, luxi, --, ere impers.
Luceres |  Luceres, um m
lucerna |  lucerna, ae f
lucesco |  lucesco (lucisco), luxi, --, ere
luci |  luci adv.
lucide |  lucide adv.
Lucidilum |  Lucidil(um, i n
Lucidrilum |  Lucidril(um, i n
lucidus |  lucidus, a, um
lucifer |  I lucifer, era, erum m
lucifugus |  lucifugus, a, um
Lucilius |  Lucilius, a, um
lucisco |  lucisco
Lucofenum |  Lucofen(um, i n
Lucopeninum |  Lucopenin(um, i n
Lucortenum |  Lucorten(um, i n
Lucretia |  Lucretia, ae f
Lucretius |  Lucretius, a, um
lucror |  lucror, atus sum, ari
lucrosus |  lucrosus, a, um
lucrum |  lucrum, i n
lucta |  lucta, ae f
luctamen |  luctamen, inis n
luctatio |  luctatio, onis f
luctator |  luctator, oris m
luctificus |  luctificus, a, um
luctisonus |  luctisonus, a, um
lucto |  lucto, --, --, are
luctor |  luctor, atus sum, ari
luctuose |  luctuose adv.
luctuosus |  luctuosus, a, um поэт.
luctus |  luctus, us m
lucubro |  lucubro, avi, atum, are
luculentus |  luculentus, a, um
Lucullus |  Lucullus, i m
lucus |  lucus, i m
ludibrium |  ludibrium, i n
ludibundus |  ludibundus, a, um
ludicra |  ludicra, orum n
ludicrus |  ludicrus, a, um
ludificatio |  ludificatio, onis f
ludifico |  ludifico, avi, atum, are
ludificor |  ludificor, atus sum, ari
ludio |  ludio, onis m
ludius |  ludius, i m
ludo |  ludo, lusi, lusum, ere
ludus |  ludus, i m
lues |  lues, is f
Lugdunum |  Lugdunum, i m
lugeo |  lugeo, luxi, luctum, ere
lugubria |  lugubria, ium n
lugubris |  lugubris, e поэт.
lumbalis |  lumbalis, e анат.
lumbi |  lumbi, orum m
lumbocostalis |  lumbocostalis, e анат.
lumbodorsalis |  lumbodorsalis, e анат.
lumboiliacalis |  lumboiliacalis, e анат.
lumboinguinalis |  lumboinguinalis, e анат.
lumbosacralis |  lumbosacralis, e анат.
lumbricalis |  lumbricalis, e анат.
lumbricus |  lumbricus, i m
lumbus |  lumbus, i m
lumen |  lumen, inis n
Luminalum |  Luminal(um, i n
luna |  luna, ae f
lunaris |  lunaris, e
lunatus |  lunatus, a, um
luno |  luno, avi, atum, are
lunter |  lunter, tris f
lunula |  lunula, ae f
luo |  luo, lui, luitum (lutum), ere
lupa |  lupa, ae f
lupata |  lupata, orum n
lupati |  lupati, orum m
lupatus |  lupatus, a, um
Lupercalia |  Lupercalia, ium (orum) n
Lupercus |  Lupercus, i m
lupinum |  lupinum, i n
lupinus |  I lupinus, a, um m
luposus |  luposus, a, um мед.
lupus |  lupus, i m
Luridinum |  Luridin(um, i n
luridus |  luridus, a, um поэт.
Luronitum |  Luronit(um, i n
luscinia |  luscinia, ae f
luscus |  luscus, a, um
Lusitania |  Lusitania, ae f
lusor |  lusor, oris m
lustralis |  lustralis, e
lustratio |  lustratio, onis f
lustro |  lustro, avi, atum, are
lustrum |  I lustrum, i n
lusus |  lusus, us m
Luteoganum |  Luteogan(um, i n
luteolus |  luteolus, a, um
Luteopurum |  Luteopur(um, i n
Luteostabum |  Luteostab(um, i n
Luteosteronum |  Luteosteron(um, i n
Lutetia |  Lutetia, ae или Lutetia Parisiorum f
luteus |  I luteus, a, um
Lutocyclinum |  Lutocyclin(um, i n
Lutocycolum |  Lutocycol(um, i n
Lutoformum |  Lutoform(um, i n
Lutogylum |  Lutogyl(um, i n
Lutren |  Lutren (urn)
Lutromonum |  Lutromon(um, i n
Lutronum |  Lutron(um, i n
lutulentus |  lutulentus, a, um
lutum |  I lutum, i n
lux |  lux, lucis f
Luxidinum |  Luxidin(um, i n
luxuria |  luxuria, ae f
luxuries |  luxuries, ei f
luxurio |  luxurio, avi, atum, are
luxurior |  luxurior, atus sum, ari
luxuriose |  luxuriose adv.
luxuriosus |  luxuriosus, a, um
luxus |  I luxus, a, um m
Lycaeus |  Lycaeus, i m
Lyceum |  Lyceum, i n
lychnus |  lychnus, i m
Lycia |  Lycia, ae f
Lycium |  Lycium, i n
Lycopodium |  Lycopodium, i n
Lycurgus |  Lycurgus, i m
Lydasum |  Lydasum, i n
Lydia |  Lydia, ae f
lympha |  lympha (limpha), ae f
lymphadenitis |  lymphadenitis, idis f
lymphangioma |  lymphangioma, atis n
lymphaticus |  lymphaticus, a, um анат.
lymphatus |  lymphatus, a, um
lymphoblastus |  lymphoblastus, i m
lymphocytus |  lymphocytus, i m
lymphoglandula |  lymphoglandula, ae f
lymphonodulus |  lymphonodulus, i m
lymphonodus |  lymphonodus, i m
lymphopenia |  lymphopenia, ae f
lymphorrhoea |  lymphorrhoea, ae f
lymphostasis |  lymphostasis, is f
Lynaminum |  Lynamin(um, i n
Lynestoralum |  Lynestoral(um, i n
Lynoralum |  Lynoral(um, i n
lynx |  lynx, lyncis m
Lyogenum |  Lyogen(um, i n
Lyothyroninum |  Lyothyronin(um, i n
lyra |  lyra, ae f
lyrici |  lyrici, orum m
lyricus |  lyricus, a, um
Lysander |  Lysander, dri m
Lysergidum |  Lysergid(um, i n
Lysias |  Lysias, ae m
Lysimachus |  Lysimachus, i m
Lysoformium |  Lysoformium, i n
Lysolum |  Lysolum, i n
lysosoma |  lysosoma, atis n
Lysthenonum |  Lysthenon(um, i n
