Macedo |  Maced(o), onis m
Macedonia |  Macedonia, ae f
macellum |  macellum, i n
macer |  macer, cra, crum поэт.
maceratio |  maceratio, onis f
maceria |  maceria, ae f
macero |  macero, avi, atum, are
Machaon |  Machaon, onis m
machina |  machina, ae f
machinamentum |  machinamentum, i n
machinarius |  machinarius, i m
machinatio |  machinatio, onis f
machinator |  machinator, oris m
machinor |  machinor, atus sum, ari
macies |  macies, ei f
macresco |  macresco, crui, --, ere
macroblastus |  macroblastus, i m
macrocarpus |  macrocarpus, a, um биолог.
macrocephalia |  macrocephalia, ae f
macrocephalus |  macrocephalus, a, um биолог.
macrocheilia |  macrocheilia, ae f
macrococcus |  macrococcus, i m
macrocytus |  macrocytus, i m
Macrodexum |  Macrodex(um, i n
macrogametocytus |  macrogametocytus, i m
macrogenia |  macrogenia, ae f
macroglossia |  macroglossia, ae f
macromastia |  macromastia, ae f
Macropus |  Macropus, odis m
macto |  macto, avi, atum, are
mactus |  mactus, a, um voc.
macula |  macula, ae f
maculipennis |  maculipennis, e биолог.
maculo |  maculo, avi, atum, are
maculosus |  maculosus, a, um
madefacio |  madefacio, feci, factum, ere
madefio |  madefio, factus sum, fieri pass.
madeo |  madeo, dui, --, ere поэт.
madesco |  madesco, dui, --, ere
madidus |  madidus, a, um поэт.
Madiolum |  Madiol(um, i n
mador |  mador, oris m
Madribonum |  Madribon(um, i n
Madriginum |  Madrigin(um, i n
Madroxinum |  Madroxin(um, i n
Maeander |  Maeander, dri m
Maecenas |  Maecenas, atis m
maena |  maena (mena), ae f
Maeonia |  Maeonia, ae f
Maeotae |  Maeotae, arum m
Maeotis |  Maeotis, idis (idos)
maereo |  maereo, --, --, ere
maeror |  maeror, oris m
maestitia |  maestitia, ae f
maestus |  maestus, a, um
mage |  mage adv.
magicus |  magicus, a, um
magis |  I magis adv.
magister |  magister, tri m
magisterium |  magisterium, i n
magistra |  magistra, ae f
magistratus |  magistratus, us m
magmentarius |  magmentarius, a, um
magnanimitas |  magnanimitas, atis f
magnanimus |  magnanimus, a, um
magnes |  magnes, etis m
Magnesia |  Magnesia, ae f
magnetophonum |  magnetophonum, i n
magnifica |  magnifica, orum n
magnifice |  magnifice adv.
magnificentia |  magnificentia, ae f
magnificus |  magnificus, a, um compar.
magnifolius |  magnifolius, a, um биолог.
magniloquentia |  magniloquentia, ae f
magniloquus |  magniloquus, a, um
magnitudo |  magnitudo, inis f
Magnolia |  Magnolia, ae f
magnopere |  magnopere adv.
Magnosilum |  Magnosil(um, i n
magnus |  magnus, a, um compar.
Magsorbentum |  Magsorbent(um, i n
magus |  I magus, a, um m
Maja |  Maja, ae f
majalis |  majalis, is m
majestas |  majestas, atis f
Majus |  I Majus, a, um m
mala |  mala, ae f
Malabenum |  Malaben(um, i n
malacia |  malacia, ae f
Malarexum |  Malarex(um, i n
Malaricidum |  Malaricid(um, i n
malaris |  malaris, e анат.
male |  male adv.
maledice |  maledice adv.
maledico |  maledico, dixi, dictum, ere
maledictio |  maledictio, onis f
maledictum |  maledictum, i n
maledicus |  maledicus, a, um compar.
malefactum |  malefactum, i n
maleficium |  maleficium, i n
maleficus |  maleficus, a, um
Malestronum |  Malestron(um, i n
malesuadus |  malesuadus, a, um
malevolentia |  malevolentia, ae f
malevolus |  malevolus, a, um superl.
malifer |  malifer, era, erum
malificium |  malificium
maligne |  maligne adv.
malignitas |  malignitas, atis f
malignus |  malignus, a, um мед.
malitia |  malitia, ae f
malitiose |  malitiose adv.
malitiosus |  malitiosus, a, um
malivol |  malivol...
mallearis |  mallearis, e анат.
malleolaris |  malleolaris, e анат.
malleolus |  malleolus, i m
malleus |  malleus, i m
Mallophaga |  Mallophaga, orum n
Mallorylum |  Malloryl(um, i n
malo |  malo, malui, --, malle
malobathron |  malobathron (-um), i n
Malogenum |  Malogen(um, i n
Malonalum |  Malonal(um, i n
malum |  I malum, i n
malus |  I malus, a, um compar.
malva |  malva, ae f
Malysolum |  Malysol(um, i n
mamalis |  mamalis, e
Mamers |  Mamers, ertis m
Mamertini |  Mamertini, orum m
mamil |  mamil...
mamma |  mamma, ae f
mammalis |  mammalis, e анат.
mammilla |  mammilla, ae f
mammillare |  mammillare, is n
mammillaris |  mammillaris, e анат.
mammillotegmentalis |  mammillotegmentalis, e анат.
mammillothalamicus |  mammillothalamicus, a, um анат.
mammogramma |  mammogramma, atis n
mammographia |  mammographia, ae f
Mammophysinum |  Mammophysin(um, i n
manceps |  manceps, ipis m
mancipium |  mancipium, i n
mancipo |  mancipo, avi, atum, are
mancus |  mancus, a, um
mandatum |  mandatum, i n
mandatus |  mandatus, us m
mandibula |  mandibula, ae f
mandibularis |  mandibularis, e анат.
mando |  I mando, avi, atum, are
Mandubii |  Mandubii, orum m
mane |  I mane adv.
maneo |  maneo, mansi, mansum, ere
manes |  manes, ium m
manibiae |  manibiae
manicae |  manicae, arum f
manicatus |  manicatus, a, um
manifeste |  manifeste adv.
manifesto |  manifesto, avi, atum, are
manifestus |  manifestus (manufestus), a, um
maniplus |  maniplus, i m
manipretium |  manipretium
manipularis |  manipularis, e
manipulatim |  manipulatim adv.
manipulus |  manipulus (maniplus), i m
Manlius |  Manlius, a, um
Mannigenum |  Mannigen(um, i n
Mannitum |  Mannit(um, i n
Mannomustinum |  Mannomustin(um, i n
mannus |  mannus, i m
mano |  mano, avi, atum, are
mansio |  mansio, onis f
mansuefacio |  mansuefacio, feci, factum, ere
mansuefio |  mansuefio, factus sum, fieri
mansuesco |  mansuesco, suevi, suetum, ere
mansuete |  mansuete adv.
mansuetudo |  mansuetudo, inis f
mansuetus |  mansuetus, a, um
mantele |  mantele (mantile), is n
mantica |  mantica, ae f
Mantinea |  Mantinea, ae f
Mantua |  Mantua, ae f
manubiae |  manubiae (manibiae), arum f
manubriosternalis |  manubriosternalis, e анат.
manubrium |  manubrium, i n
manufestus |  manufestus, a, um
manufollium |  manufollium, i n
manumissio |  manumissio, onis f
manumitto |  manumitto, misi, missum, ere
manupretium |  manupretium n
manus |  manus, us f
mapalia |  mapalia, ium n
mappa |  mappa, ae f
Maraslavinum |  Maraslavin(um, i n
Marathon |  Marathon, onis f
marathrus |  marathrus, i m
Marboranum |  Marboran(um, i n
Marcellus |  Marcellus, i m
marceo |  marceo, ui, --, ere
marcesco |  marcesco, --, --, ere
marcidus |  marcidus, a, um
Marcius |  Marcius, i m
Marcomani |  Marcomani, orum m
Marcus |  Marcus, i m
Mardonius |  Mardonius, i m
mare |  mare, is n
Marecainum |  Marecain(um, i n
margarita |  margarita, ae f
margino |  margino, avi, atum, are
margo |  margo, inis m
Margonovinum |  Margonovin(um, i n
marinus |  marinus, a, um
marita |  marita, ae f
maritalis |  maritalis, e
maritima |  maritima, orum n
maritimus |  maritimus (maritumus), a, um
marito |  marito, avi, atum, are
maritus |  I maritus, a, um m
Marius |  Marius, a, um
Marizilum |  Marizil(um, i n
marmor |  marmor, oris n
marmoreus |  marmoreus, a, um поэт.
Maro |  Maro, onis m
Mars |  Mars, Martis m
Marsalidum |  Marsalid(um, i n
Marsi |  Marsi, orum m
Marsilidum |  Marsilid(um, i n
Martialis |  Martialis, is m
Martius |  I Martius, a, um m
mas |  I mas, maris n
masculinus |  masculinus, a, um
masculus |  I masculus, a, um m
Masdiolum |  Masdiol(um, i n
Masinissa |  Masinissa, ae m
massa |  massa, ae f
Massagetae |  Massagetae, arum m
massetericus |  massetericus, a, um анат.
mastectomia |  mastectomia, ae f
masticatorius |  masticatorius, a, um анат.
masticatus |  masticatus, a, um анат.
mastitis |  mastitis, idis f
Mastodontus |  Mastodontus, i m
mastoideus |  mastoideus, a, um анат.
mastopathia |  mastopathia, ae f
mastruca |  mastruca (mastruga), ae f
mastrucatus |  mastrucatus, a, um
matara |  matara, ae f
mater |  mater, tris f
matercula |  matercula, ae f
materia |  materia, ae f
materiatus |  materiatus, a, um
materior |  materior, --, ari
materis |  materis
maternus |  maternus, a, um
matertera |  matertera, ae f
mathematicus |  mathematicus, a, um
Matricaria |  I Matricaria, ae f
matricida |  matricida, ae m
matrimonium |  matrimonium, i n
matrimus |  matrimus, a, um
Matrimycinum |  Matrimycin(um, i n
matrix |  matrix, icis f
matrona |  matrona, ae f
matronalis |  matronalis, e
mature |  mature adv.
maturesco |  maturesco, maturui, --, ere
maturitas |  maturitas, atis f
maturo |  maturo, avi, atum, are pass.
maturus |  maturus, a, um
Matuta |  Matuta, ae f
matutinus |  matutinus, a, um
Mauri |  Mauri, orum m
maxilla |  maxilla, ae f
maxillaris |  maxillaris, e анат.
maxime |  I maxime (maxume) adv.
maximopere |  maximopere
maximus |  maximus (maxumus), a, um superl.
maxume |  maxume
mazonomus |  mazonomus, i m
mea |  mea, ae f
meatus |  meatus, us m
Mebedrolum |  Mebedrol(um, i n
Mebubarbitalum |  Mebubarbital(um, i n
Mecaprinum |  Mecaprin(um, i n
Mechloralum |  Mechloral(um, i n
Mechlorethaminum |  Mechlorethamin(um, i n
Mecodinum |  Mecodin(um, i n
Meconium |  Meconium, i n
meddix |  meddix (medix), icis m
Medea |  Medea, ae f
medeor |  medeor, --, eri
Medi |  Medi, orum m
Media |  Media, ae f
medialis |  medialis, e анат.
medianum |  medianum, i n
medianus |  medianus, a, um
mediastinalis |  mediastinalis, e анат.
mediastinographia |  mediastinographia, ae f
mediastinum |  mediastinum, i n
mediastinus |  mediastinus, i m
medica |  medica, ae f
medicabilis |  medicabilis, e
Medicago |  Medicago, inis f
Medicainum |  Medicain(um, i n
medicamen |  medicamen, inis n
medicamentosus |  medicamentosus, a, um мед.
medicamentum |  medicamentum, i n
medicatus |  I medicatus, a, um part.
medicina |  medicina, ae f
medicinalis |  medicinalis, e мед.
medico |  medico, avi, atum, are
medicor |  medicor, atus sum, ari
medicus |  I medicus, a, um m
medietas |  medietas, atis f
medimnum |  medimnum, i n
Medinalum |  Medinal(um, i n
medioclavicularis |  medioclavicularis, e анат.
mediocris |  mediocris, e
mediocritas |  mediocritas, atis f
mediocriter |  mediocriter adv.
Mediolanum |  Mediolanum (-ium), i n
Medisum |  Medis(um, i n
meditatio |  meditatio, onis f
meditatus |  meditatus, a, um
mediterranea |  mediterranea, orum n
mediterraneus |  mediterraneus, a, um
meditor |  meditor, atus sum, ari
medium |  medium, i n
medius |  medius, a, um
medix |  medix
medulla |  medulla, ae f
medullaris |  medullaris, e анат.
medullosus |  medullosus, a, um анат.
Medusa |  Medusa, ae f
megacolon |  megacolon, i n
Megaera |  Megaera, ae f
megalocephalia |  megalocephalia, ae f
megalocytus |  megalocytus, i m
megalodactylia |  megalodactylia, ae f
megalomania |  megalomania, ae f
megalosplenia |  megalosplenia, ae f
Megaphenum |  Megaphen(um, i n
megaphyllus |  megaphyllus, a, um биолог.
Megara |  Megara, ae f
Megibalum |  Megibal(um, i n
Megimidum |  Megimid(um, i n
mehercule |  mehercule (mehercle, mehercules) interj.
mei |  mei, orum m
mejo |  mejo, --, --, ere
Mekvalonum |  Mekvalon(um, i n
mel |  mel, mellis n
Meladininum |  Meladinin(um, i n
melania |  melania, ae f
melanochrysus |  melanochrysus, a, um биолог.
melanodermia |  melanodermia, ae f
melanoma |  melanoma, atis n
melanopterus |  melanopterus, a, um биолог.
melanosoma |  melanosoma, atis n
melanosporus |  melanosporus, a, um биолог.
melanuria |  melanuria, ae f
melanurus |  melanurus, i m
Meletinum |  Meletin(um, i n
melilotos |  melilotos, i m
melimelum |  melimelum, i n
Melinum |  Melin(um, i n
Melipraminum |  Melipramin(um, i n
melisphyllum |  melisphyllum, i n
melius |  melius compar.
Mellarilum |  Mellaril(um, i n
Mellerilum |  Melleril(um, i n
Mellictinum |  Mellictin(um, i n
mellifer |  mellifer, era, erum биолог.
Mellinesum |  Mellines(um, i n
mellitus |  mellitus, a, um мед.
melos |  melos ( pl.
Meloxinum |  Meloxin(um, i n
Melphalanum |  Melphalan(um, i n
Melpomene |  Melpomene, es f
Melsominum |  Melsomin(um, i n
Melus |  Melus, i f
membrana |  membrana, ae f
membranaceus |  membranaceus, a, um анат.
membranosus |  membranosus, a, um анат.
membratim |  membratim adv.
membrum |  membrum, i n
memini |  memini, meminisse defect.
Memnon |  Memnon, onis m
memor |  memor, oris
memorabilis |  memorabilis, e
memorandus |  memorandus, a, um
memoria |  memoria, ae f
memoriter |  memoriter adv.
memoro |  memoro, avi, atum, are
Memphis |  Memphis, idis f
mena |  mena, ae f
Menander |  Menander (Menandrus), dri m
menda |  menda, ae f
mendacium |  mendacium, i n
mendax |  I mendax, acis m
mendicitas |  mendicitas, atis, f
mendico |  mendico, avi, atum, are
mendicus |  mendicus, a, um
mendosus |  mendosus, a, um
mendum |  mendum, i n
Meneleus |  Meneleus, i m
Menformonum |  Menformon(um, i n
meningitis |  meningitis, idis f
meningocele |  meningocele, es f
meningoencephalitis |  meningoencephalitis, idis f
meningolysis |  meningolysis, is f
meninx |  meninx, ingis f
meniscofemoralis |  meniscofemoralis, e анат.
meniscus |  meniscus, i m
mens |  mens, mentis f
mensa |  mensa, ae f
mensarius |  mensarius, i m
mensis |  mensis, is m
mensor |  mensor, oris m
menstruum |  menstruum, i n
menstruus |  menstruus, a, um
mensura |  mensura, ae f
mensus |  mensus, a, um part.
menta |  menta, ae f
mentalis |  mentalis, e анат.
Mentha |  I Mentha, ae f
Mentholum |  Menthol(um, i n
mentio |  mentio, onis f
mentior |  mentior, itus sum, iri
mentitus |  mentitus, a, um
mentolabialis |  mentolabialis, e анат.
mentum |  mentum, i n
Menyanthes |  Menyanthes, ei f
Menzylanum |  Menzylan(um, i n
meo |  meo, avi, atum, are
Meoninum |  Meonin(um, i n
Mepacrinum |  Mepacrin(um, i n
Mepanitum |  Mepanit(um, i n
Mepavlonum |  Mepavlon(um, i n
Mepazinum |  Mepazin(um, i n
Meperidinum |  Meperidin(um, i n
Mephenaminum |  Mephenamin(um, i n
Mephenesinum |  Mephenesin(um, i n
Mephenonum |  Mephenon(um, i n
mephitis |  mephitis, is ( acc.
Mepholinum |  Mepholin(um, i n
Meprobamatum |  Meprobamat(um, i n
Meprobanum |  Meproban(um, i n
Meprodatum |  Meprodat(um, i n
Meprospanum |  Meprospan(um, i n
Meprotanum |  Meprotan(um, i n
Mequalonum |  Mequalon(um, i n
meracus |  meracus, a, um
Meratranum |  Meratran(um, i n
mercabilis |  mercabilis, e
Mercaleukinum |  Mercaleukin(um, i n
Mercaptaminum |  Mercaptamin(um, i n
Mercaptopurinum |  Mercaptopurin(um, i n
Mercapurenum |  Mercapuren(um, i n
Mercapurinum |  Mercapurin(um, i n
mercator |  mercator, oris m
mercatura |  mercatura, ae f
mercatus |  I mercatus, a, um m
Mercazolilum |  Mercazolil(um, i n
Mercazolum |  Mercazol(um, i n
mercennarius |  I mercennarius, a, um m
merces |  merces, edis f
Mercloranum |  Mercloran(um, i n
mercor |  mercor, atus sum, ari
Mercupurinum |  Mercupurin(um, i n
Mercurius |  Mercurius, i m
Mercurophyllinum |  Mercurophyllin(um, i n
Mercusalum |  Mercusal(um, i n
Mercuzanthinum |  Mercuzanthin(um, i n
Mercuzanum |  Mercuzan(um, i n
merda |  merda, ae f
mereo |  mereo, ui, itum, ere
meretricius |  meretricius, a, um
meretricula |  meretricula, аe f
meretrix |  meretrix, icis f
merges |  merges, itis f
mergo |  mergo, mersi, mersum, ere pass.
mergus |  mergus, i m
meridianus |  meridianus, a, um
meridies |  meridies, ei m
Meridilum |  Meridil(um, i n
meridionalis |  meridionalis, e анат.
Merilidum |  Merilid(um, i n
merito |  I merito adv.
meritorius |  meritorius, a, um
meritum |  meritum, i n
merologia |  merologia, ae f
Meropeninum |  Meropenin(um, i n
merops |  merops, opis m
Merparanum |  Merparan(um, i n
merso |  merso, avi, atum, are
Merthyllinum |  Merthyllin(um, i n
merula |  merula, ae f
merum |  merum, i n
merus |  merus, a, um
merx |  merx, mercis f
mesaraicus |  mesaraicus, a, um анат.
Mesatonum |  Mesaton(um, i n
mesencephalon |  mesencephalon, i n
mesenchyma |  mesenchyma, atis n
mesenterialis |  mesenterialis, e анат.
mesentericus |  mesentericus, a, um
mesenterium |  mesenterium, i n
mesoappendix |  mesoappendix, icis f
mesoblastus |  mesoblastus, i m
Mesocainum |  Mesocain(um, i n
mesocolon |  mesocolon, i n
mesocranium |  mesocranium, i n
mesoderma |  mesoderma, atis n
mesoduodenum |  mesoduodenum, i n
mesogastrium |  mesogastrium, i n
mesohepaticum |  mesohepaticum, i n
mesometrium |  mesometrium, i n
mesonephricus |  mesonephricus, a, um анат.
mesonephros |  mesonephros, i m
mesopharynx |  mesopharynx, yngis m
mesorchium |  mesorchium, i n
mesorectum |  mesorectum, i n
mesosalpinx |  mesosalpinx, ingis f
mesotendineum |  mesotendineum, i n
mesothelium |  mesothelium, i
mesovaricus |  mesovaricus, a, um анат.
mesovarium |  mesovarium, i n
Mesphenalum |  Mesphenal(um, i n
Messalina |  Messalina, ae f
Messana |  Messana, ae f
messias |  messias, ae m
messis |  messis, is f
messor |  messor, oris m
messorius |  messorius, a, um
Mestendiolum |  Mestendiol(um, i n
Mestinonum |  Mestinon(um, i n
meta |  meta, ae f
metabolismus |  metabolismus, i m
metacarpalia |  metacarpalia, ium n
metacarpalis |  metacarpalis, e анат.
metacarpeus |  metacarpeus, a, um анат.
metacarpus |  metacarpus, i m
Metacortalonum |  Metacortalon(um, i n
Metacortandracinum |  Metacortandracin(um, i n
Metacortandrolonum |  Metacortandrolon(um, i n
Metacortenum |  Metacorten(um, i n
Metacyclinum |  Metacyclin(um, i n
metallum |  metallum, i n
metameria |  metameria, ae f
metamerium |  metamerium, i n
Metaminum |  Metamin(um, i n
Metamizolum |  Metamizol(um, i n
Metamizylum |  Metamizyl(um, i n
metamorphosis |  metamorphosis, is f
Metanabolum |  Metanabol(um, i n
Metandienonum |  Metandienon(um, i n
Metandiolum |  Metandiol(um, i n
Metandrenum |  Metandren(um, i n
Metandriolum |  Metandriol(um, i n
metanephros |  metanephros, i m
metaphysis |  metaphysis, is f
metaplasia |  metaplasia, ae f
Metapyrinum |  Metapyrin(um, i n
metastasis |  metastasis, is f
metastaticus |  metastaticus, a, um мед.
metatarsalis |  metatarsalis, e анат.
metatarseus |  metatarseus, a, um анат.
metatarsus |  metatarsus, i m
metathalamus |  metathalamus, i m
metator |  metator, oris m
Metellus |  Metellus, i m
metencephalon |  metencephalon, i n
Methacinum |  Methacin(um, i n
Methacyclinum |  Methacyclin(um, i n
Methadienonum |  Methadienon(um, i n
Methaformum |  Methaform(um, i n
Methafronum |  Methafron(um, i n
Methamphetaminum |  Methamphetamin(um, i n
Methamphinum |  Methamphin(um, i n
Methandriolum |  Methandriol(um, i n
Methandrostenolonum |  Methandrostenolon(um, i n
Methaphyllinum |  Methaphyllin(um, i n
Methaqualonum |  Methaqualon(um, i n
Methazidum |  Methazid(um, i n
Methedrinum |  Methedrin(um, i n
Methenaminum |  Methenamin(um, i n
Metherazinum |  Metherazin(um, i n
Metherlharmidum |  Metherlharmid(um, i n
Methexenylum |  Methexenyl(um, i n
Methicilum |  Methicil(um, i n
Methimazolum |  Methimazol(um, i n
Methindolum |  Methindol(um, i n
Methiocilum |  Methiocil(um, i n
Methioninum |  Methionin(um, i n
Methochinum |  Methochin(um, i n
Methofluranum |  Methofluran(um, i n
Methonium |  Methonium, i n
Methophenazinum |  Methophenazin(um, i n
Methopterinum |  Methopterin(um, i n
Methoquinum |  Methoquin(um, i n
Methorinum |  Methorin(um, i n
Methostanum |  Methostan(um, i n
Methotnyrinum |  Methotnyrin(um, i n
Methotrexatum |  Methotrexat(um, i n
Methotrimeprazinum |  Methotrimeprazin(um, i n
Methoxalenum |  Methoxalen(um, i n
Methoxyfluranum |  Methoxyfluran(um, i n
Methoxypsoralenum |  Methoxypsoralen(um, i n
Methoxysalenum |  Methoxysalen(um, i n
Methozinum |  Methozin(um, i n
Methylaminopterinum |  Methylaminopterin(um, i n
Methylandrostendiolum |  Methylandrostendiol(um, i n
Methylapogalanthaminum |  Methylapogalanthamin(um, i n
Methylbenzedrinum |  Methylbenzedrin(um, i n
Methyldopum |  Methyldop(um, i n
Methylencyclinum |  Methylencyclin(um, i n
Methylergobrevinum |  Methylergobrevin(um, i n
Methylergonovinum |  Methylergonovin(um, i n
Methylhexabarbitalum |  Methylhexabarbital(um, i n
Methylhexobitalum |  Methylhexobital(um, i n
Methylisominum |  Methylisomin(um, i n
Methyloestradiolum |  Methyloestradiol(um, i n
Methylsulfazinum |  Methylsulfazin(um, i n
Methylthiouracilum |  Methylthiouracil(um, i n
Methyluracilum |  Methyluracil(um, i n
Meticortelonum |  Meticortelon(um, i n
Meticortenum |  Meticorten(um, i n
Metindolum |  Metindol(um, i n
Metiodolum |  Metiodol(um, i n
Metionum |  Metion(um, i n
metior |  metior, mensus sum, iri поэт.
Metisazonum |  Metisazon(um, i n
meto |  meto, messui, mesaum, ere поэт.
Metofanum |  Metofan(um, i n
metor |  metor, atus sum, ari
Metoxinum |  Metoxin(um, i n
metra |  metra, ae f
Metraminum |  Metramin(um, i n
Metrazolum |  Metrazol(um, i n
metrographia |  metrographia, ae f
Metronidazolum |  Metronidazol(um, i n
Metronilum |  Metronil(um, i n
metroptosis |  metroptosis, is f
metrorrhagia |  metrorrhagia, ae f
metrorrhexis |  metrorrhexis, is f
metrosalpingographia |  metrosalpingographia, ae f
Metrovalum |  Metroval(um, i n
metuo |  metuo, tui, tutum, ere
metus |  metus, us m
Metyrinum |  Metyrin(um, i n
meum |  meum, i n
meus |  meus, a, um voc.
Mexaformum |  Mexaform(um, i n
Mexaminum |  Mexamin(um, i n
Mezulonum |  Mezulon(um, i n
Miadonum |  Miadon(um, i n
mica |  mica, ae f
mico |  mico, cui, --, are
microcarpus |  microcarpus, a, um биолог.
microccphalicus |  microccphalicus, a, um мед.
microcephalia |  microcephalia, ae f
Microchiroptera |  Microchiroptera, orum n
microchirurgia |  microchirurgia, ae f
Microcidum |  Microcid(um, i n
micrococcus |  micrococcus, i m
Microfollinum |  Microfollin(um, i n
microgastria |  microgastria, ae f
microgenia |  microgenia, ae f
microglossia |  microglossia, ae f
micrognathia |  micrognathia, ae f
Microiodum |  Microiod(um, i n
micromastia |  micromastia, ae f
Micropeninum |  Micropenin(um, i n
Microplastum |  Microplast(um, i n
micropterus |  micropterus, a, um биолог.
microscopia |  microscopia, ae f
microscopicus |  microscopicus, a, um анат.
microscopium |  microscopium, i n
microsplenia |  microsplenia, ae f
Microsporum |  Microsporum, i n
Microsulfum |  Microsulf(um, i n
Mictinum |  Mictin(um, i n
Midantanum |  Midantan(um, i n
Midetonum |  Mideton(um, i n
Midicelum |  Midicel(um, i n
Midikelum |  Midikel(um, i n
Midosalum |  Midosal(um, i n
migrans |  migrans, antis анат.
migratio |  migratio, onis f
migratorius |  migratorius, a, um биолог.
migro |  migro, avi, atum, are
Mikostatinum |  Mikostatin(um, i n
mile |  mile
miles |  miles, itis m
milesimus |  milesimus
Miletus |  Miletus, i f
mili |  mili...
milia |  milia pl.
militaris |  militaris, e
militariter |  militariter adv.
militia |  militia, ae f
milito |  milito, avi, atum, are
milium |  milium, i n
mille |  mille adj.
millesimum |  millesimum adv.
millesimus |  millesimus, a, um
milliarium |  milliarium, i n
milliarius |  milliarius, a, um
Millicortenum |  Millicorten(um, i n
millies |  millies adv.
Milocordinum |  Milocordin(um, i n
Miltiades |  Miltiades, is (i) m
Miltownum |  Miltown(um, i n
milu |  milu...
milvinus |  milvinus, a, um
milvus |  milvus, i m
mima |  mima, ae f
mimicus |  mimicus, a, um
mimula |  mimula, ae f
mimus |  mimus, i m
mina |  mina, ae f
minaciter |  minaciter adv.
minae |  minae, arum f
Minalginum |  Minalgin(um, i n
minanter |  minanter adv.
minax |  minax, acis
Minerva |  Minerva, ae f
mingo |  mingo, minxi, mictum, ere
minime |  minime adv.
minimus |  minimus, a, um superl.
minister |  minister, tri m
ministerium |  ministerium, i n
ministra |  ministra, ae f
ministrator |  ministrator, oris m
ministro |  ministro, avi, atum, are
minitabundus |  minitabundus, a, um
minitor |  minitor, atus sum, ari
minium |  minium, i n
Minocainum |  Minocain(um, i n
minor |  I minor, atus sum, ari compar.
Minorinum |  Minorin(um, i n
Minos |  Minos, ois m
Minozinanum |  Minozinan(um, i n
Mintacolum |  Mintacol(um, i n
minume |  minume adv.
minumus |  minumus, a, um
minuo |  minuo, nui, nutum, ere pass.
minus |  minus compar.
minutatim |  minutatim adv.
minutus |  minutus, a, um биолог.
Miocholum |  Miochol(um, i n
Mioridolum |  Mioridol(um, i n
Miotisalum |  Miotisal(um, i n
mirabile |  mirabile (rete) анат.
mirabilis |  mirabilis, e
mirabiliter |  mirabiliter adv.
mirabundus |  mirabundus, a, um
miraculum |  miraculum, i n
mirandus |  mirandus, a, um
mirator |  mirator, oris m
mire |  mire adv.
Mirenilum |  Mirenil(um, i n
mirifice |  mirifice adv.
mirificus |  mirificus, a, um
mirmicophilus |  mirmicophilus, a, um биолог.
mirmillo |  mirmillo, onis m
miror |  miror, atus sum, ari
mirus |  mirus, a, um
misceo |  misceo, miscui, mistum поэт.
Miscleronum |  Miscleron(um, i n
miser |  miser, era, erum
miserabilis |  miserabilis, e
miserabiliter |  miserabiliter adv.
miserandus |  miserandus, a, um
miseratio |  miseratio, onis f
misere |  misere adv.
misereor |  misereor, seritus sum, eri
miseresco |  miseresco, --, --, ere
miseria |  miseria, ae f
misericordia |  misericordia, ae f
misericors |  misericors, cordis
miseror |  miseror, atus sum, ari
missa |  missa, ae f
missilis |  missilis, e
missio |  missio, onis f
missito |  missito, avi, atum, are
missor |  missor, oris m
missus |  missus, us m
Misulbanum |  Misulban(um, i n
mite |  mite adv.
mitella |  mitella, ae f
mitesco |  mitesco, --, --, ere
Mithridates |  Mithridates, is m
mitigo |  mitigo, avi, atum, are
mitis |  mitis, e
Mitostanum |  Mitostan(um, i n
mitoticus |  mitoticus, a, um анат.
mitra |  mitra, ae f
mitto |  mitto, misi, missum, ere
mixtura |  mixtura, ae f
Mizodinum |  Mizodin(um, i n
Mobenolum |  Mobenol(um, i n
mobilis |  mobilis, e
mobilitas |  mobilitas, atis f
mobiliter |  mobiliter adv.
Modecatum |  Modecat(um, i n
moderabilis |  moderabilis, e
moderamen |  moderamen, inis f
moderate |  moderate adv.
moderatio |  moderatio, onis f
moderator |  moderator, oris m
moderatrix |  moderatrix, icis f
moderatus |  moderatus, a, um
moderor |  moderor, atus sum, ari
modeste |  modeste adv.
modestia |  modestia, ae f
modestus |  modestus, a, um
modice |  modice adv.
modicus |  modicus, a, um
modifico |  modifico, avi, atum, are
modiolus |  modiolus, i m
Moditenum |  Moditen(um, i n
modius |  modius, i m
modo |  modo adv.
modulator |  modulator, oris m
modulatus |  modulatus, a, um
modulor |  modulor, atus sum, ari
modulus |  modulus, i m
modus |  modus, i m
moecha |  moecha, ae f
moechor |  moechor, atus sum, ari
moechus |  moechus, i m
moenia |  moenia, ium n
Moenus |  Moenus, i m
moer |  moer...
Moesia |  Moesia, ae f
moest |  moest...
Mogadanum |  Mogadan(um, i n
Mogadonum |  Mogadon(um, i n
mola |  mola, ae f
molaris |  molaris, is m
Moldaminum |  Moldamin(um, i n
molecularis |  molecularis, e хим.
moles |  moles, is f
moleste |  moleste adv.
molestia |  molestia, ae f
molestus |  molestus, a, um
molimen |  molimen, inis n
molimentum |  molimentum, i n
molior |  molior, itus sum, iri
molitio |  molitio, onis f
molitor |  molitor, oris m
mollesco |  mollesco, --, --, ere
mollio |  mollio, ivi (ii), itum, ire
mollis |  mollis, e
molliter |  molliter adv.
mollitia |  mollitia, ae f
mollitudo |  mollitudo, inis f
molo |  molo, ui, itum, ere
moly |  moly, yos n
momentum |  momentum, i n
Monacortum |  Monacort(um, i n
monedula |  monedula, ae f
moneo |  moneo, nui, nitum, ere
moneris |  moneris, is f
moneta |  I moneta, ae f
monile |  monile, is n
monimentum |  monimentum
monita |  monita, orum n
monitio |  monitio, onis f
monitor |  monitor, oris m
monitus |  monitus, us m
monocephalus |  monocephalus, a, um биолог.
monocyticus |  monocyticus, a, um мед.
monocytopenia |  monocytopenia, ae f
monocytopoesis |  monocytopoesis, is f
monocytus |  monocytus, i m
monodactylia |  monodactylia, ae f
monogamia |  monogamia, ae f
monogynus |  monogynus, a, um биолог.
mononeuritis |  mononeuritis, idis f
monopetalus |  monopetalus, a, um биолог.
monophobia |  monophobia, ae f
monoplegia |  monoplegia, ae f
monopodium |  monopodium, i n
mons |  mons, montis m
monstrator |  monstrator, oris m
monstratus |  monstratus, a, um
monstro |  monstro, avi, atum, are поэт.
monstrum |  monstrum, i n
montana |  montana, orum n
montani |  montani, orum m
montanus |  montanus, a, um поэт.
monticola |  monticola, ae m
monticulus |  monticulus, i m
montivagus |  montivagus, a, um
montuosus |  montuosus (montosus), a, um
monumentum |  monumentum, i n
mora |  I mora, ae f
Moramidum |  Moramid(um, i n
morati |  morati, orum m
morator |  morator, oris m
moratus |  I moratus, a, um part.
morbus |  morbus, i m
mordaciter |  mordaciter adv.
mordax |  mordax, acis поэт.
mordeo |  mordeo, momordi, morsum, ere
mordicus |  mordicus adv.
moretum |  moretum, i n
moribundus |  moribundus, a, um поэт.
morigeror |  morigeror, atus sum, ari
morior |  morior, mortuus sum, mori part.
mormyr |  mormyr, yris f
Moronalum |  Moronal(um, i n
moror |  moror, atus sum, ari поэт.
morose |  morose adv.
morositas |  morositas, atis f
morosus |  morosus, a, um
Morpheus |  Morpheus (=Morphe^us), eos m
Morphinum |  Morphin(um, i n
Morphocyclinum |  Morphocyclin(um, i n
morphogenesis |  morphogenesis, is f
morphologia |  I morphologia, ae f
mors |  mors, mortis f
morsus |  morsus, us m
mortale |  mortale, is n
mortalia |  mortalia, ium n
mortalis |  I mortalis, e m
mortalitas |  mortalitas, atis f
mortifer |  mortifer, era, erum
mortiferus |  mortiferus, a, um
mortuus |  I mortuus, a, um m
morum |  morum, i n
morus |  morus, i f
mos |  mos, moris m
Mosa |  Mosa, ae m
Mosatilum |  Mosatil(um, i n
moto |  moto, --, --, are
Motolonum |  Motolon(um, i n
motor |  motor, oris m
motus |  motus, us m
moveo |  moveo, movi, motum, ere pass.
mox |  mox adv.
mucilago |  mucilago, inis f
mucosa |  mucosa, ae f
mucosus |  mucosus, a, um анат.
mucro |  mucro, onis m
mucus |  mucus, i m
mugio |  mugio, ivi (ii), itum, ire
mugitus |  mugitus, us m
mula |  mula, ae f
mulceo |  mulceo, mulsi, mulsum, ere
mulco |  mulco, avi, atum, are
mulcta |  mulcta...
mulctra |  mulctra, ae f
mulctrarium |  mulctrarium, i n
mulctrum |  mulctrum, i n
mulgeo |  mulgeo, mulsi, mulctum, ere
muliebria |  muliebria, ium n
muliebris |  muliebris, e
muliebriter |  muliebriter adv.
mulier |  mulier, eris f
mulierarius |  mulierarius, a, um
muliercula |  muliercula, ae f
mulio |  mulio, onis m
mulionius |  mulionius, a, um
mullus |  mullus, i m
mulsum |  mulsum, i n
multa |  multa, ae f
multangulus |  multangulus, a, um анат.
multaticius |  multaticius, a, um
multatio |  multatio, onis f
multicavus |  multicavus, a, um
multicellularis |  multicellularis, e биолог.
multifariam |  multifariam adv.
multifidus |  multifidus, a, um
multiflorus |  multiflorus, a, um биолог.
multiformis |  multiformis, e
multiforus |  multiforus, a, um
Multifugum |  Multifug(um, i n
multijugis |  multijugis, e
multijugus |  multijugus, a, um
multimodis |  multimodis adv.
multiplex |  I multiplex, icis pl.
multiplico |  multiplico, avi, atum, are
multitudo |  multitudo, inis f
multo |  I multo (mulcto), avi, atum, are adv.
multum |  multum adv.
multus |  multus, a, um compar.
mulus |  mulus, i m
munditia |  munditia, ae f
mundities |  mundities, ei f
mundus |  I mundus, a, um m
munero |  munero, avi, atum, are
muneror |  muneror, atus sum, ari
munia |  munia, ium n
municeps |  municeps, ipis m
municipalis |  municipalis, e
municipium |  municipium, i n
munifice |  munifice adv.
munificentia |  munificentia, ae f
munificus |  munificus, a, um compar.
munimen |  munimen, inis n
munimentum |  munimentum, i n
munio |  munio, ivi (ii), itum, ire
munitio |  munitio, onis f
munito |  munito, --, --, are
munitor |  munitor, oris m
munitus |  munitus, a, um
munus |  munus, eris n
munusculum |  munusculum, i n
muraena |  muraena
muralis |  muralis, e
Murelum |  Murel(um, i n
murena |  murena, ae f
murex |  murex, icis m
muria |  muria, ae f
murmillo |  murmillo
murmur |  murmur, uris n
murmuro |  murmuro, avi, atum, are
murra |  murra (murrha или myrrha), ae f
murreus |  murreus (murrheus, myrrheus), a, um
murrha |  murrha
murtetum |  murtetum (myrtetum), i n
murteus |  murteus (myrteus), a, um
murtum |  murtum (myrtum), i n
murtus |  murtus (myrtus), i f
murus |  murus, i m
mus |  mus, muris m
Musae |  Musae, arum f
Musaeus |  Musaeus, i m
muscipula |  muscipula, ae f
muscipulum |  muscipulum, i n
muscosus |  muscosus, a, um
muscularis |  muscularis, e анат.
musculocutaneus |  musculocutaneus, a, um анат.
musculoperoneus |  musculoperoneus, a, um анат.
musculophrenicus |  musculophrenicus, a, um анат.
musculosus |  musculosus, a, um анат.
musculotubarius |  musculotubarius, a, um анат.
musculus |  musculus, i m
muscus |  muscus, i m
musica |  I musica, ae f
musicus |  I musicus, a, um m
mussito |  mussito, --, --, are
musso |  musso, --, --, are поэт.
Mustargenum |  Mustargen(um, i n
mustela |  mustela (mustella), ae f
Mustinum |  Mustin(um, i n
mustum |  mustum, i n
mutabilis |  mutabilis, e
mutagenum |  mutagenum, i n
mutatio |  mutatio, onis f
mutilo |  mutilo, avi, atum, are
mutilus |  I mutilus, a, um m
muto |  I muto, avi, atum, are pass.
mutuatio |  mutuatio, onis f
mutulus |  mutulus
mutuo |  mutuo adv.
mutuor |  mutuor, atus sum, ari
mutus |  mutus, a, um
mutuum |  mutuum, i n
mutuus |  mutuus, a, um dat.
myalgia |  myalgia, ae f
Myambutolum |  Myambutol(um, i n
Myanesinum |  Myanesin(um, i n
Myarsenolum |  Myarsenol(um, i n
Myastigminum |  Myastigmin(um, i n
Myasulfum |  Myasulf(um, i n
Mycale |  Mycale, es f
Mycaptinum |  Mycaptin(um, i n
Mycenae |  Mycenae, arum f
Mycerinum |  Mycerin(um, i n
Mycetophagus |  Mycetophagus, i m
Mycivinum |  Mycivin(um, i n
mycobacterium |  mycobacterium, i n
mycologus |  mycologus, i m
Mycoseptinum |  Mycoseptin(um, i n
Mycostatinum |  Mycostatin(um, i n
mycotrophus |  mycotrophus, a, um биолог.
Mycozidum |  Mycozid(um, i n
Mydetonum |  Mydeton(um, i n
Mydocalmum |  Mydocalm(um, i n
myelencephalon |  myelencephalon, i n
Myeleukonum |  Myeleukon(um, i n
myelitis |  myelitis, idis f
Myelobromolum |  Myelobromol(um, i n
myelocytus |  myelocytus i m
Myelodilum |  Myelodil(um, i n
myelofibrosis |  myelofibrosis, is f
myelographia |  myelographia, ae f
myelopathia |  myelopathia, ae f
myelopathicus |  myelopathicus, a, um мед.
Myelosanum |  Myelosan(um, i n
myelotomia |  myelotomia, ae f
myentericus |  myentericus, a, um анат.
Mylecytanum |  Mylecytan(um, i n
Mylepsinum |  Mylepsin(um, i n
Myleranum |  Myleran(um, i n
mylohyoideus |  mylohyoideus, a, um анат.
Mynalum |  Mynal(um, i n
Myoarseminum |  Myoarsemin(um, i n
myocardiodystrophia |  myocardiodystrophia, ae f
myocarditis |  myocarditis, idis f
myocardium |  myocardium, i n
Myodilum |  Myodil(um, i n
myologia |  myologia, ae f
myoma |  myoma, atis n
myomerium |  myomerium, i n
myometrium |  myometrium, i n
myomorphus |  myomorphus, a, um биолог.
Myonum |  Myon(um, i n
myoparo |  myoparo, onis m
myopathia |  myopathia, ae f
myopathicus |  myopathicus, a, um мед.
myopia |  myopia, ae f
myoplegia |  myoplegia, ae f
Myosalvarsanum |  Myosalvarsan(um, i n
myosclerosis |  myosclerosis, is f
myosepta |  myosepta, orum n
myositis |  myositis, idis f
myotomia |  myotomia, ae f
Myotriphosum |  Myotriphos(um, i n
Myoxylum |  Myoxyl(um, i n
myrica |  myrica, ae f
myrice |  myrice, es f
Myrmidones |  Myrmidones, um m
myrmillo |  myrmillo
myrr |  myrr...
myrt |  myrt...
Myrticolorinum |  Myrticolorin(um, i n
Myrtillus |  Myrtillus, i f
Mysolinum |  Mysolin(um, i n
mystagogus |  mystagogus, i m
mysterium |  mysterium, i n
mystes |  mystes, ae m
mysticus |  mysticus, a, um
Mysulbanum |  Mysulban(um, i n
mytilus |  mytilus, i m
Myvizonum |  Myvizon(um, i n
Myxiodum |  Myxiod(um, i n
