nablium |  nablium, i n
Nactonum |  Nacton(um, i n
Nadisalum |  Nadisal(um, i n
Nadisanum |  Nadisan(um, i n
nae |  nae adv.
naenia |  naenia
Naevius |  Naevius, a, um
naevus |  naevus, i m
Naias |  Naias, adis или Nais, idis (idos) f
Nalidixanum |  Nalidixan(um, i n
Nalidixinum |  Nalidixin(um, i n
Nallinum |  Nallin(um, i n
Nalorphinum |  Nalorphin(um, i n
Nalutronum |  Nalutron(um, i n
nam |  nam conj.
namque |  namque conj.
nanciscor |  nanciscor, nactus (nanctus) sum, nancisci
Nanophynum |  Nanophyn(um, i n
napaeus |  napaeus, a, um
Napharinum |  Napharin(um, i n
Naphazolinum |  Naphazolin(um, i n
Naphthalanum |  Naphthalan(um, i n
Naphthammonum |  Naphthammon(um, i n
Naphthyzinum |  Naphthyzin(um, i n
Napotonum |  Napoton(um, i n
Narbo |  Narbo, onis m
Narcangylum |  Narcangyl(um, i n
narcissus |  narcissus, i m
Narcodormum |  Narcodorm(um, i n
Narcogenum |  Narcogen(um, i n
Narcolanum |  Narcolan(um, i n
Narconitum |  Narconit(um, i n
Narcorenum |  Narcoren(um, i n
Narcosanum |  Narcosan(um, i n
Narcotanum |  Narcotan(um, i n
nardum |  nardum, i n
nardus |  nardus, i f
naris |  naris, is f
narrabilis |  narrabilis, e
narrata |  narrata, orum n
narratio |  narratio, onis f
narratiuncula |  narratiuncula, ae f
narratus |  narratus, us m
narro |  narro, avi, atum, are
narta |  narta, ae f
narus |  narus
nasalis |  nasalis, e анат.
nascor |  nascor, natus sum, nasci поэт.
Nasica |  Nasica, ae m
Naso |  Naso, onis m
nasolabialis |  nasolabialis, e анат.
nasopalatinus |  nasopalatinus, a, um анат.
nasturtium |  nasturtium (nasturcium), i n
nasus |  nasus, i m
nasutus |  nasutus, a, um
nata |  nata (gnata), ae f
natales |  natales, ium m
natalicia |  natalicia, ae f
natalicius |  natalicius, a, um m
natalis |  I natalis, e поэт.
natator |  natator, oris m
Natidigoxinum |  Natidigoxin(um, i n
natio |  natio, onis f
natis |  natis, is f
nativus |  nativus, a, um
nato |  nato, avi, atum, are поэт.
Natorexicum |  Natorexic(um, i n
Natrium |  Natrium, i n
natrix |  natrix, icis f
natura |  natura, ae f
naturalis |  naturalis, e биолог.
naturaliter |  naturaliter adv.
natus |  I natus (gnatus), i m
nauarchus |  nauarchus, i m
Naucainum |  Naucain(um, i n
naufragium |  naufragium, i n
naufragus |  naufragus, a, um поэт.
nausea |  nausea, ae f
nauseo |  nauseo, avi, atum, are
nauta |  nauta, ae m
nautici |  nautici, orum m
nauticus |  nauticus, a, um
navale |  navale, is n
navalia |  navalia, ium n
navalis |  navalis, e
navarchus |  navarchus, i m
navicula |  navicula, ae f
navicularia |  navicularia, ae f
navicularicuneiformis |  navicularicuneiformis, e анат.
navicularilunatus |  navicularilunatus, a, um анат.
navicularis |  navicularis, e анат.
navicularius |  I navicularius, a, um m
naviculocuboideus |  naviculocuboideus, a, um анат.
navifragus |  navifragus, a, um
navigabilis |  navigabilis, e
navigatio |  navigatio, onis f
navigiolum |  navigiolum, i n
navigium |  navigium, i n
navigo |  navigo, avi, atum, are поэт.
navis |  navis, is f
navita |  navita, ae m
navitas |  navitas (gnavitas), atis f
naviter |  naviter (gnaviter) adv.
navo |  navo, avi, atum, are
navus |  navus, a, um
Naxus |  Naxus (-оs), i f
ne |  I ne adv.
Neapolis |  Neapolis, is f
nebula |  nebula, ae f
nebulo |  nebulo, onis m
nebulosus |  nebulosus, a, um
nec |  nec
necdum |  necdum (nequedum) conj.
necessarie |  necessarie adv.
necessario |  necessario adv.
necessarius |  I necessarius, a, um n
necesse |  necesse adv.
necessitas |  necessitas, atis f
necessitudo |  necessitudo, inis f
necessum |  necessum est
neco |  neco, avi, atum, are
necopinans |  necopinans, antis
necopinatus |  necopinatus, a, um
necrosis |  necrosis, is f
nectar |  nectar, aris n
nectareus |  nectareus, a, um
necto |  necto, nexui (nexi), nexum, ere,
necubi |  necubi adv.
necunde |  necunde adv.
necupinus |  necupinus, a, um
Nederlandia |  Nederlandia, ae f
nedum |  nedum adv.
neencephalon |  neencephalon, i n
nefandus |  nefandus, a, um
nefarie |  nefarie adv.
nefarium |  nefarium, i n
nefarius |  nefarius, a, um
nefas |  nefas n
nefastus |  nefastus, a, um
Nefrixum |  Nefrix(um, i n
Neftinum |  Neftin(um, i n
negatio |  negatio, onis, f
negito |  negito, avi, --, are
neglectio |  neglectio, onis f
neglectus |  neglectus, a, um
negleg |  negleg...
negligens |  negligens, entis
negligenter |  negligenter adv.
negligentia |  negligentia, ae f
negligo |  negligo, neglexi, neglectum, ere
nego |  nego, avi, atum, are
negotiatio |  negotiatio, onis f
negotiator |  negotiator, oris m
negotior |  negotior, atus sum, ari
negotiosus |  negotiosus, a, um
negotium |  negotium, i n
Negramum |  Negram(um, i n
nematocaulis |  nematocaulis, e биолог.
Nematoctonum |  Nematocton(um, i n
Nematodes |  Nematodes, um f
Nemesis |  Nemesis, eus f
nemo |  nemo, inis gen.
nemoralis |  nemoralis, e
nemorosus |  nemorosus, a, um поэт.
nempe |  nempe conj.
nemus |  nemus, oris n
nenia |  nenia (naenia), ae f
neo |  neo, nevi, netum, ere поэт.
Neoadiganum |  Neoadigan(um, i n
Neoanusolum |  Neoanusol(um, i n
Neoarseminum |  Neoarsemin(um, i n
Neoarsphenaminum |  Neoarsphenamin(um, i n
Neobenzinolum |  Neobenzinol(um, i n
neocerebellum |  neocerebellum, i n
Neocidum |  Neocid(um, i n
Neocolenum |  Neocolen(um, i n
Neocompensanum |  Neocompensan(um, i n
neocortex |  neocortex, icis m
neocytosis |  neocytosis, is f
Neodrenalum |  Neodrenal(um, i n
Neodrinum |  Neodrin(um, i n
Neoepinephrinum |  Neoepinephrin(um, i n
Neoeserinum |  Neoeserin(um, i n
Neogynofortum |  Neogynofort(um, i n
Neohydrazidum |  Neohydrazid(um, i n
Neohydrinum |  Neohydrin(um, i n
Neoinsoralum |  Neoinsoral(um, i n
Neolaxum |  Neolax(um, i n
Neolutinum |  Neolutin(um, i n
Neomagnolum |  Neomagnol(um, i n
Neomelubrinum |  Neomelubrin(um, i n
neopallium |  neopallium, i n
Neoperheparum |  Neoperhepar(um, i n
Neophedanum |  Neophedan(um, i n
Neophrynum |  Neophryn(um, i n
Neophyllinum |  Neophyllin(um, i n
Neoptolemus |  Neoptolemus, i m
Neosalvarsanum |  Neosalvarsan(um, i n
Neospectum |  Neospect(um, i n
Neosteronum |  Neosteron(um, i n
Neostibosanum |  Neostibosan(um, i n
neostriatum |  neostriatum, i n
Neostrophanum |  Neostrophan(um, i n
Neosulfonum |  Neosulfon(um, i n
Neotebenum |  Neoteben(um, i n
Neothyllinum |  Neothyllin(um, i n
Neotreparsenanum |  Neotreparsenan(um, i n
Neozepamum |  Neozepam(um, i n
Neozinum |  Neozin(um, i n
Nephentinum |  Nephentin(um, i n
Nephramidum |  Nephramid(um, i n
nephrectomia |  nephrectomia, ae f
Nephridinum |  Nephridin(um, i n
nephritis |  nephritis, idis f
nephrogenus |  nephrogenus, a, um мед.
nephrolithiasis |  nephrolithiasis, is f
nephrolithotomia |  nephrolithotomia, ae f
nephrolithus |  nephrolithus, i m
nephronum |  nephronum, i n
nephropathia |  nephropathia, ae f
nephroptosis |  nephroptosis, is f
nephropyelostomia |  nephropyelostomia, ae f
nephros |  nephros, i m
nephrosclerosis |  nephrosclerosis, is f
nephrosis |  nephrosis, is f
nepos |  I nepos, otis m
neptis |  neptis, is f
Neptunius |  Neptunius, a, um
Neptunus |  Neptunus, i m
nequam |  nequam adj.
nequaquam |  nequaquam adv.
neque |  neque (nec) conj.
nequedum |  nequedum
nequeo |  nequeo, ivi (ii), itum, ire
nequicquam |  nequicquam
nequidquum |  nequidquum
nequior |  nequior
nequiquam |  nequiquam adv.
nequissimus |  nequissimus, a, um superl.
nequiter |  nequiter adv.
nequitia |  nequitia, ae f
Nere |  Nere^us, eos (ei) m
Nereis |  Nereis, idos f
Neriolinum |  Neriolin(um, i n
Nero |  Nero, onis m
Nerobolilum |  Nerobolil(um, i n
Nerobolum |  Nerobol(um, i n
Nerva |  Nerva, ae m
Nervatilum |  Nervatil(um, i n
Nervii |  Nervii, orum m
nervosus |  nervosus, a, um анат.
nervus |  nervus, i m
nescio |  nescio, ivi (ii), itum, ire
nescius |  nescius, a, um
Nesdonalum |  Nesdonal(um, i n
Nessus |  Nessus, i m
Nestor |  Nestor, oris m
Netocidum |  Netocid(um, i n
neu |  neu
Neulactilum |  Neulactil(um, i n
Neuleptilum |  Neuleptil(um, i n
Neuractilum |  Neuractil(um, i n
neuralgia |  neuralgia, ae f
neuralis |  neuralis, e анат.
neurectomia |  neurectomia, ae f
neuritis |  neuritis, idis f
Neurobenzilum |  Neurobenzil(um, i n
neuroblastus |  neuroblastus, i m
neurocranium |  neurocranium, i n
neurocytus |  neurocytus, i m
neuroepithelium |  neuroepithelium, i n
neurofibrae |  neurofibrae, arum f
neurogenus |  neurogenus, a, um мед.
neurohypophysis |  neurohypophysis, is f
Neuroleptilum |  Neuroleptil(um, i n
neurologia |  neurologia, ae f
neuroma |  neuroma, atis n
neuronum |  neuronum, i n
neuropathia |  neuropathia, ae f
neuropathologia |  neuropathologia, ae f
neuropathologus |  neuropathologus, i m
Neuropaxum |  Neuropax(um, i n
neurophyllus |  neurophyllus, a, um биолог.
Neuroptera |  Neuroptera, orum n
neurorrhaphia |  neurorrhaphia, ae f
neurosis |  neurosis is f
neurosus |  neurosus, a, um мед.
neurotomia |  neurotomia, ae f
Neurotrastum |  Neurotrast(um, i n
Neusulfonum |  Neusulfon(um, i n
neuter |  neuter, tra, trum gen.
neutiquam |  neutiquam adv.
Neutraflavinum |  Neutraflavin(um, i n
Neutraphyllinum |  Neutraphyllin(um, i n
neutro |  neutro adv.
Neutropenum |  Neutropen(um, i n
neve |  neve (ne^u) adv.
Nevigramonum |  Nevigramon(um, i n
Nevodiurexum |  Nevodiurex(um, i n
nex |  nex, necis f
nexilis |  nexilis, e
nexum |  nexum, i n
nexus |  nexus, us m
ni |  ni conj.
Niacinamidum |  Niacinamid(um, i n
Niacinum |  Niacin(um, i n
Niadrinum |  Niadrin(um, i n
Nialamidum |  Nialamid(um, i n
Niamidum |  Niamid(um, i n
Nibuphinum |  Nibuphin(um, i n
Nicaea |  Nicaea, ae f
Nicamidum |  Nicamid(um, i n
nicator |  nicator, oris m
Nicazidum |  Nicazid(um, i n
Nicethamidum |  Nicethamid(um, i n
Niclosamidum |  Niclosamid(um, i n
Nicodanum |  Nicodan(um, i n
Nicodinum |  Nicodin(um, i n
Nicodonum |  Nicodon(um, i n
Nicoformum |  Nicoform(um, i n
Nicofortum |  Nicofort(um, i n
Niconacidum |  Niconacid(um, i n
Nicorinum |  Nicorin(um, i n
Nicospanum |  Nicospan(um, i n
Nicotenum |  Nicoten(um, i n
Nicotinamidum |  Nicotinamid(um, i n
Nicotolum |  Nicotol(um, i n
Nicoverinum |  Nicoverin(um, i n
Nicovitum |  Nicovit(um, i n
Nicozidum |  Nicozid(um, i n
nidor |  nidor, oris m
nidus |  nidus, i m
Nifulidonum |  Nifulidon(um, i n
Nifurantinum |  Nifurantin(um, i n
niger |  niger, gra, grum поэт.
nigresco |  nigresco, grui, --, ere
nigricornis |  nigricornis, e биолог.
nigrimaculatus |  nigrimaculatus, a, um биолог.
nigro |  nigro, avi, atum, are
nigrum |  nigrum, i n
nihil |  I nihil (поэт. nil) n
nihildum |  nihildum adv.
nihilominus |  nihilominus
nihilum |  I nihilum поэт.
Nikethamidum |  Nikethamid(um, i n
Nikoformum |  Nikoform(um, i n
Nikorinum |  Nikorin(um, i n
nil |  nil
Nilacidum |  Nilacid(um, i n
nilum |  nilum
Nilus |  Nilus, i m
nimbifer |  nimbifer, era, erum
nimbosus |  nimbosus, a, um
nimbus |  nimbus, i m
nimio |  nimio adv.
nimirum |  nimirum adv.
nimis |  nimis adv.
nimium |  I nimium adv.
nimius |  nimius, a, um
ningit |  ningit (ninguit), ninxit, --, ere impers.
Nioba |  Nioba, ae f
Nioformum |  Nioform(um, i n
Nipodalum |  Nipodal(um, i n
nisi |  nisi conj.
Nisolonum |  Nisolon(um, i n
Nistatinum |  Nistatin(um, i n
nisus |  I nisus (nixus), us m
Nitazolum |  Nitazol(um, i n
nitedula |  nitedula, ae f
nitens |  I nitens, entis поэт.
niteo |  niteo, tui, --, ere
nitesco |  nitesco, --, --, ere
nitidus |  nitidus, a, um
nitor |  I nitor, nisus (nixus) sum, niti m
Nitranginum |  Nitrangin(um, i n
Nitranolum |  Nitranol(um, i n
nitras |  nitras, atis m
Nitrazepamum |  Nitrazepam(um, i n
Nitrinalum |  Nitrinal(um, i n
Nitrocardiolum |  Nitrocardiol(um, i n
Nitrofurantoinum |  Nitrofurantoin(um, i n
Nitrofurazonum |  Nitrofurazon(um, i n
Nitrofurmenthonum |  Nitrofurmenthon(um, i n
Nitroglycerinum |  Nitroglycerin(um, i n
Nitroglycerolum |  Nitroglycerol(um, i n
Nitroglynum |  Nitroglyn(um, i n
Nitromintum |  Nitromint(um, i n
Nitropenthritum |  Nitropenthrit(um, i n
Nitropentonum |  Nitropenton(um, i n
Nitrosorbidum |  Nitrosorbid(um, i n
nitrosus |  nitrosus, a, um биолог.
nitrum |  nitrum, i n
Nivachinum |  Nivachin(um, i n
Nivalinum |  Nivalin(um, i n
nivalis |  nivalis, e поэт.
Nivaquinum |  Nivaquin(um, i n
niveus |  niveus, a, um
nivosus |  nivosus, a, um
nix |  nix, nivis f
nixor |  nixor, --, --, ari
nixus |  I nixus, a, um part.
Nizotinum |  Nizotin(um, i n
NN. |  NN. сокр. от
NN.BB. |  NN.BB. сокр. от
no |  no, navi, --, nare поэт.
Nobadormum |  Nobadorm(um, i n
nobilis |  nobilis, e
nobilitas |  nobilitas, atis f
nobilito |  nobilito, avi, atum, are
nocens |  nocens, entis
noceo |  noceo, nocui, nocitum, ere
nocivus |  nocivus, a, um
noctiluca |  noctiluca, ae f
noctivagus |  noctivagus, a, um
Noctopanum |  Noctopan(um, i n
noctu |  noctu adv.
noctua |  noctua, ae f
nocturnus |  nocturnus, a, um
noctuus |  noctuus, a, um биолог.
nocuus |  nocuus, a, um
nodo |  nodo, (avi), atum, are поэт.
nodosus |  I nodosus, a, um анат.
nodulus |  nodulus, i m
nodus |  nodus, i m
Nogramum |  Nogram(um, i n
nolo |  nolo, nolui, --, nolle
nomen |  nomen, inis n
nomenclatio |  nomenclatio, onis f
nomenclator |  nomenclator (nomenculator), oris m
nomenclatura |  nomenclatura, ae f
Nometanum |  Nometan(um, i n
Nomillonum |  Nomillon(um, i n
nominatim |  nominatim adv.
nominatio |  nominatio, onis f
nomino |  nomino, avi, atum, are
nomisma |  nomisma, atis n
non |  non adv.
nona |  nona, ae f
nonae |  nonae, arum f
nonagesimus |  nonagesimus, a, um
nonagies |  nonagies (nonagiens) adv.
nonaginta |  nonaginta
nonanus |  nonanus, a, um
nondum |  nondum adv.
nongentesimus |  nongentesimus, a, um
nongenti |  nongenti, ae, a
nonne |  nonne
nonnullus |  nonnullus, a, um
nonnumquam |  nonnumquam adv.
nonus |  nonus, a, um
Norepinephrinum |  Norepinephrin(um, i n
Norexadrinum |  Norexadrin(um, i n
Norfinum |  Norfin(um, i n
Noricum |  Noricum, i n
norma |  norma, ae f
normalis |  normalis, e анат.
Normanoxum |  Normanox(um, i n
Normorestum |  Normorest(um, i n
Norstenolum |  Norstenol(um, i n
Norsulfazolum |  Norsulfazol(um, i n
nos |  nos pl.
Noscapinum |  Noscapin(um, i n
noscito |  noscito, avi, atum, are
nosco |  nosco, novi, notum, noscere
nosocomium |  nosocomium, i n
Nospanum |  Nospan(um, i n
noster |  noster, nostra, nostrum
nostra |  nostra, orum n
nostras |  nostras, atis
nostri |  nostri, orum m
nota |  nota, ae f
notabilis |  notabilis, e
notatio |  notatio, onis f
notatus |  notatus, a, um
notesco |  notesco, tui, --, ere
Notezinum |  Notezin(um, i n
nothus |  nothus, a, um
notio |  notio, onis f
notitia |  notitia, ae f
noto |  noto, avi, atum, are
notus |  I notus (notos), i m
Novabolum |  Novabol(um, i n
novacula |  novacula, ae f
novale |  novale, is n
Novalginum |  Novalgin(um, i n
novalis |  I novalis, e f
Novamidazophenum |  Novamidazophen(um, i n
Novamidonum |  Novamidon(um, i n
Novamidum |  Novamid(um, i n
Novaminum |  Novamin(um, i n
Novapyrinum |  Novapyrin(um, i n
Novarsanum |  Novarsan(um, i n
Novarsenobenzenum |  Novarsenobenzen(um, i n
Novarsenolum |  Novarsenol(um, i n
Novasmosolum |  Novasmosol(um, i n
novatrix |  novatrix, icis f
nove |  nove adv.
novellus |  novellus, a, um
novem |  novem
November |  I November, bris m
Novembichinum |  Novembichin(um, i n
Novembitolum |  Novembitol(um, i n
novendialis |  novendialis (novemdialis), e
noveni |  noveni, ae, a
noverca |  noverca, ae f
novercalis |  novercalis, e
novicius |  novicius, a, um
novies |  novies adv.
Noviodunum |  Noviodunum, i n
novitas |  novitas, atis f
novo |  novo, avi, atum, are поэт.
Novobiocinum |  Novobiocin(um, i n
Novocainum |  Novocain(um, i n
Novocamidum |  Novocamid(um, i n
Novocephalginum |  Novocephalgin(um, i n
Novocillinum |  Novocillin(um, i n
Novodrinum |  Novodrin(um, i n
Novoimaninum |  Novoimanin(um, i n
Novomycinum |  Novomycin(um, i n
Novopanum |  Novopan(um, i n
novum |  novum, i, n
novus |  novus, a, um superl.
nox |  nox, noctis f
noxa |  noxa, ae f
Noxalum |  Noxal(um, i n
noxia |  noxia, ae f
noxius |  noxius, a, um
Nozinanum |  Nozinan(um, i n
nubecula |  nubecula, ae f
nubes |  nubes, is f
nubifer |  nubifer, era, erum
nubigena |  nubigena, ae m
nubila |  nubila, orum n
nubilis |  nubilis, e
nubilus |  nubilus, a, um
nubo |  nubo, nupsi, nuptum, ere,
nucha |  nucha, ae f
nucleus |  nucleus, i m
nudius |  nudius (nunc dius, nunc dies)
nudo |  nudo, avi, atum, are воен.
nudus |  nudus, a, um
nugae |  nugae, arum f
nugator |  nugator, oris m
nugatorius |  nugatorius, a, um
nugor |  nugor, atus sum, ari
nulla |  nulla, ae f
nullum |  nullum, i n
nullus |  I nullus, a, um gen.
num |  num adv.
numa |  numa...
Numantia |  Numantia, ae f
numen |  numen, inis n
numerabilis |  numerabilis, e
numeratum |  numeratum, i n
numeratus |  numeratus, a, um
numero |  numero, avi, atum, are
numerosus |  numerosus, a, um
numerus |  numerus, i m
Numida |  Numida, ae m
Numidia |  Numidia, ae f
Numitor |  Numitor, oris m
nummarius |  nummarius, a, um
nummatus |  nummatus, a, um
nummulus |  nummulus, i m
nummus |  nummus (numus), i m
numnam |  numnam
numne |  numne
numquam |  numquam
numus |  numus
nunc |  nunc adv.
nunci |  nunci...
nuncia |  nuncia...
nuncubi |  nuncubi
nuncupatio |  nuncupatio, onis f
nuncupo |  nuncupo, avi, atum, are
nundinae |  nundinae, arum f
nundinatio |  nundinatio, onis f
nundinor |  nundinor, atus sum, ari
nundinum |  nundinum, i n
nundinus |  nundinus, a, um
nunquam |  nunquam adv.
nuntia |  nuntia, ae f
nuntiatio |  nuntiatio, onis f
nuntio |  nuntio, avi, atum, are
nuntium |  nuntium, i n
nuntius |  I nuntius, a, um m
nuo |  nuo, ere
nuper |  nuper adv.
nupta |  nupta, ae f
nuptiae |  nuptiae, arum f
nuptialis |  nuptialis, e
nurus |  nurus, us f
nusquam |  nusquam adv.
nuto |  nuto, avi, atum, are
nutricius |  I nutricius, a, um анат.
nutricor |  nutricor, atus sum, ari
nutricula |  nutricula, ae f
nutriens |  nutriens, ntis биолог.
nutrimen |  nutrimen, inis n
nutrimenta |  nutrimenta, orum n
nutrio |  nutrio, ivi (ii), itum, ire поэт.
nutrior |  nutrior, --, iri
nutrix |  nutrix, icis f
nutus |  nutus, us m
nux |  nux, nucis f
Nyazinum |  Nyazin(um, i n
Nyctalum |  Nyctal(um, i n
Nydranum |  Nydran(um, i n
Nydrazidum |  Nydrazid(um, i n
nympha |  nympha, ae f
Nysa |  Nysa (Nyssa), ae f
Nyseus |  Nyseus (=Nyse^us), ei (eos) m
Nystafunginum |  Nystafungin(um, i n
Nystatinum |  Nystatin(um, i n
