ob |  ob praep cum acc.
obaerati |  obaerati, orum m
obaeratus |  obaeratus, a, um
obambulo |  obambulo, avi, atum, are
obarmo |  obarmo, --, --, are
obaro |  obaro, avi, --, are
obc |  obc...
obdo |  obdo, didi, ditum, ere
obdormio |  obdormio, ivi (ii), itum, ire
obdormisco |  obdormisco, mivi, --, ere
obduco |  obduco, duxi, ductum, ere
obductio |  obductio, onis f
obduresco |  obduresco, durui, --, ere,
obduro |  obduro, --, --, are
obed |  obed...
obeo |  obeo, ivi (ii), itum, ire поэт.
obequito |  obequito, avi, atum, are
oberro |  oberro, avi, atum, are
obesus |  obesus, a, um поэт.
obex |  I obex m
obf |  obf...
obicio |  obicio
obirascor |  obirascor, --, irasci
obiratus |  obiratus, a, um
obiter |  obiter adv.
obitus |  obitus, us m
objaceo |  objaceo, cui, --, ere
objectatio |  objectatio, onis f
objecto |  objecto, avi, atum, are
objectus |  I objectus, a, um part.
objex |  objex (obex), icis m
objicio |  objicio (obicio), jeci, jectum, ere pass.
objurgatio |  objurgatio, onis f
objurgator |  objurgator, oris m
objurgo |  objurgo, avi, atum, are
oblectamen |  oblectamen, inis n
oblectamentum |  oblectamentum, i n
oblectatio |  oblectatio, onis f
oblecto |  oblecto, avi, atum, are pass.
oblicus |  oblicus, a, um
oblido |  oblido, lisi, lisum, ere
obligatio |  obligatio, onis f
obligatus |  obligatus, a, um
obligo |  obligo, avi, atum, are pass.
oblimo |  oblimo, avi, atum, are поэт.
oblino |  oblino, levi, litum, ere
oblique |  oblique adv.
obliquo |  obliquo, avi, atum, are
obliquus |  obliquus, a, um
oblitero |  oblitero
oblitesco |  oblitesco, tui, --, ere
oblittero |  oblittero (oblitero), avi, atum, are pass.
oblivio |  oblivio, onis f
obliviosus |  obliviosus, a, um
obliviscor |  obliviscor, oblitus sum, oblivisci
oblivium |  oblivium, i n
oblongatus |  oblongatus, a, um биолог.
oblongus |  oblongus, a, um
obloquor |  obloquor, quutus (cutus) sum, loqui поэт.
obluctor |  obluctor, atus sum, ari
obmolior |  obmolior, litus sum, iri
obmurmuro |  obmurmuro, avi, atum, are
obmutesco |  obmutesco, mutui, --, ere
obnascor |  obnascor, natus sum, nasci
obnitor |  obnitor, nixus (nisus) sum, niti
obnixe |  obnixe adv.
obnixus |  obnixus, a, um
obnoxie |  obnoxie adv.
obnoxius |  obnoxius, a, um
obnubo |  obnubo, --, --, ere
obnuntiatio |  obnuntiatio, onis f
obnuntio |  obnuntio, avi, atum, are
oboediens |  oboediens, entis
oboedienter |  oboedienter adv.
oboedientia |  oboedientia, ae f
oboedio |  oboedio, ivi, itum, ire
oborior |  oborior, ortus sum, iri
obrepo |  obrepo, repsi, reptum, ere
obrigesco |  obrigesco, rigui, --, ere
obrogo |  obrogo, avi, atum, are
obruo |  obruo, rui, rutum, ere
obrussa |  obrussa, ae f
obsaepio |  obsaepio, saepsi, saeptum, ire
obscoena |  obscoena, orum n
obscoenitas |  obscoenitas, atis f
obscoenum |  obscoenum, i, n
obscoenus |  obscoenus, a, um
obscuratio |  obscuratio, onis f
obscure |  obscure adv.
obscuritas |  obscuritas, atis f
obscuro |  obscuro, avi, atum, are pass.
obscurum |  obscurum, i n
obscurus |  obscurus, a, um
obsecratio |  obsecratio, onis f
obsecro |  obsecro, avi, atum, are
obsecundo |  obsecundo, avi, atum, are
obsepio |  obsepio
obsequela |  obsequela (obsequella), ae f
obsequens |  obsequens, entis
obsequenter |  obsequenter adv.
obsequentia |  obsequentia, ae f
obsequium |  obsequium, i n
obsequor |  obsequor, quutus (cutus) sum, sequi
obsero |  I obsero, avi, atum, are
observans |  observans, antis
observantia |  observantia, ae f
observatio |  observatio, onis f
observo |  observo, avi, atum, are поэт.
obses |  obses, idis m
obsessio |  obsessio, onis f
obsessor |  obsessor, oris m
Obsidanum |  Obsidan(um, i n
obsideo |  obsideo, sedi, sessum, ere
obsidio |  obsidio, onis f
obsidionalis |  obsidionalis, e
obsidium |  obsidium, i n
obsido |  obsido, sedi, sessum, ere
obsignator |  obsignator, oris m
obsigno |  obsigno, avi, atum, are
obsisto |  obsisto, stiti, stitum, ere
obsitus |  obsitus, a, um
obsolefio |  obsolefio, factus sum, fieri
obsolete |  obsolete adv.
obsoletus |  obsoletus, a, um
obsonium |  obsonium, i n
obsono |  obsono, avi, atum, are
obsonor |  obsonor, atus sum, ari
obstetrix |  obstetrix, icis f
obstinate |  obstinate adv.
obstinatio |  obstinatio, onis f
obstinatus |  obstinatus, a, um
obstino |  obstino, avi, atum, are
obstipesco |  obstipesco
obstipus |  obstipus, a, um
obsto |  obsto, stiti, (statum), are
obstringo |  obstringo, strinxi, strictum, ere
obstructio |  obstructio, onis f
obstrudo |  obstrudo
obstruo |  obstruo, struxi, structum, ere
obstupefacio |  obstupefacio, feci, factum, ere
obstupefactus |  obstupefactus, a, um
obstupesco |  obstupesco, pui, --, ere
obsulesco |  obsulesco, levi, --, ere
obsum |  obsum, obfui (offui), obesse
obsuo |  obsuo, sui, sutum, ere
obsurdesco |  obsurdesco, dui, --, ere
obtego |  obtego, texi, tectum, ere
obtempero |  obtempero, avi, atum, are
obtendo |  obtendo, tendi, tentum, ere
obtentus |  obtentus, us m
obtero |  obtero, trivi, tritum, ere
obtestatio |  obtestatio, onis f
obtestor |  obtestor, atus sum, ari
obtexo |  obtexo, --, --, ere
obticesco |  obticesco, ticui, --, ere
obtineo |  obtineo, tinui, tentum, ere
obtingo |  obtingo, tigi, --, ere
obtorpesco |  obtorpesco, pui, --, ere
obtorqueo |  obtorqueo, (torsi), tortum, ere
obtrectatio |  obtrectatio, onis f
obtrectator |  obtrectator, oris m
obtrecto |  obtrecto, avi, atum, are
obtrudo |  obtrudo, trusi, trusum, ere
obtrunco |  obtrunco, avi, atum, are
obtundo |  obtundo, tudi, tusum (tunsum), ere
obtunsus |  I obtunsus, a, um part.
obturator |  obturator, oris m
obturatorius |  obturatorius, a, um анат.
obturbo |  obturbo, avi, atum, are
obturo |  obturo, avi, atum, are
obtusus |  obtusus (obtunsus), a, um
obtutus |  obtutus, us m
obumbro |  obumbro, avi, atum, are
obuncus |  obuncus, a, um
obustus |  obustus, a, um
obvallatus |  obvallatus, a, um анат.
obvallo |  obvallo, (avi), atum, are
obvenio |  obvenio, veni, ventum, ire
obversor |  obversor, atus sum, ari
obverto |  obverto (obvorto), verti (vorti), versum (vorsum), ere pass.
obviam |  obviam adv.
obvius |  obvius, a, um поэт.
obvolvo |  obvolvo, volvi, volutum, ere поэт.
occaeco |  occaeco, avi, atum, are
occallesco |  occallesco, callui, --, ere
occano |  occano, canui, --, ere
occasio |  occasio, onis f
occasus |  occasus, us m
occatio |  occatio, onis f
occidens |  occidens, entis m
occidio |  occidio, onis f
occido |  I occido, cidi, casum, ere
occiduus |  occiduus, a, um поэт.
occino |  occino, cinui, centum, ere
occipio |  occipio, cepi, ceptum, ere
occipitalis |  occipitalis, e анат.
occipitofrontalis |  occipitofrontalis, e анат.
occipitotemporalis |  occipitotemporalis, e анат.
occiput |  occiput, itis n
occisio |  occisio, onis f
occludo |  occludo, clusi, clusum, ere
occlusalis |  occlusalis, e анат.
occo |  occo, avi, atum, are
occoepi |  occoepi, --, coepisse
occubo |  occubo, cubui, cubitum, are
occulco |  occulco, avi, atum, are
occulo |  occulo, cului, cultum, ere
occulta |  occulta, orum n
occultatio |  occultatio, onis f
occultator |  occultator, oris m
occulte |  occulte adv.
occulto |  occulto, avi, atum, are
occultus |  occultus, a, um
occumbo |  occumbo, cubui, cubitum, ere поэт.
occupatio |  occupatio, onis f
occupatus |  occupatus, a, um
occupo |  occupo, avi, atum, are
occurro |  occurro, curri, cursum, ere
occursatio |  occursatio, onis f
occurso |  occurso, avi, atum, are
occursus |  occursus, us m
Oceanus |  Oceanus, i m
ocellus |  ocellus, i m
Ocinum |  Ocinum, i n
ocior |  ocior, oris adj.
ocissime |  ocissime adv.
ociter |  ociter adv.
ocius |  ocius adv.
ocrea |  ocrea, ae f
ocreatus |  ocreatus, a, um
Octadinum |  Octadin(um, i n
Octathionum |  Octathion(um, i n
Octavianus |  Octavianus, i m
octavus |  octavus, a, um
octies |  octies (octiens) adv.
Octilinum |  Octilin(um, i n
octingentesimus |  octingentesimus, a, um
octingenti |  octingenti, ae, a
octipes |  octipes, edis
octo |  octo
October |  I October, bris, bre m
octodecim |  octodecim
Octoestrolum |  Octoestrol(um, i n
octogeni |  octogeni, ae, a
octogesimus |  octogesimus, a, um
octogies |  octogies (octogiens) adv.
octoginta |  octoginta
octojugis |  octojugis, e
octoni |  octoni, ae, a
octopetalus |  octopetalus, a, um биолог.
octophoron |  octophoron, i n
octophoros |  octophoros, on
octoplicatus |  octoplicatus, a, um
octuplum |  octuplum, i n
octuplus |  octuplus, a, um
octussis |  octussis, is m
ocularis |  ocularis, e анат.
oculista |  oculista, ae m
oculomotorius |  oculomotorius, a, um анат.
oculus |  oculus, i m
odi |  odi, --, odisse part.
odiose |  odiose adv.
odiosus |  odiosus, a, um
odium |  odium, i n
odontalgia |  odontalgia, ae f
odontoblastus |  I odontoblastus, i m
odontogenus |  odontogenus, a, um мед.
odontoideus |  odontoideus, a, um анат.
odontonia |  odontonia, atis n
odontophyllus |  odontophyllus, a, um биолог.
odontorrhagia |  odontorrhagia, ae f
odor |  odor, oris m
odorans |  odorans, antis биолог.
odoratus |  I odoratus, a, um part.
odorifer |  odorifer, era, erum
odoro |  odoro, avi, atum, are
odoror |  odoror, atus sum, ari
odorus |  odorus, a, um
odos |  odos, oris m
Odyssea |  Odyssea, ae f
oedema |  oedema, atis n
Oedipus |  Oedipus, odis m
oenophorum |  oenophorum, i n
oesophagus |  oesophagus, i m
Oestradiolum |  Oestradiol(um, i n
Oestralynum |  Oestralyn(um, i n
Oestramenolum |  Oestramenol(um, i n
Oestramonum |  Oestramon(um, i n
Oestrinum |  Oestrin(um, i n
Oestrobinum |  Oestrobin(um, i n
Oestrogeninum |  Oestrogenin(um, i n
Oestroglandolum |  Oestroglandol(um, i n
Oestrogynonum |  Oestrogynon(um, i n
Oestrolum |  Oestrol(um, i n
Oestromeninum |  Oestromenin(um, i n
Oestronum |  Oestron(um, i n
Oestroperosum |  Oestroperos(um, i n
Oestrostilbenum |  Oestrostilben(um, i n
Oestrosyntalum |  Oestrosyntal(um, i n
oestrus |  oestrus, i m
oesypum |  oesypum, i n
offa |  offa, ae f
offendo |  offendo, tendi, fensum, ere pass.
offensa |  offensa, ae f
offensio |  offensio, onis f
offensiuncula |  offensiuncula, ae f
offenso |  offenso, --, --, are
offensus |  offensus, a, um
offero |  offero, obtuli, oblatum, offerre pass.
officina |  officina, ae f
officinalis |  officinalis, e мед.
officio |  officio, feci, fectum, ere
officiosus |  officiosus, a, um
officium |  officium, i n
offigo |  offigo, --, --, ere
offirmo |  offirmo, avi, atum, are
offulgeo |  offulgeo, fulsi, --, ere
offundo |  offundo, fudi, fusum, ere pass.
ohe |  ohe! interj.
Oileus |  Oileus (=Oile^us), ei (eos) m
Olbia |  Olbia, ae f
olea |  olea, ae f
oleaginus |  oleaginus, a, um
Oleandocetinum |  Oleandocetin(um, i n
Oleandocynum |  Oleandocyn(um, i n
Oleandomycinum |  Oleandomycin(um, i n
Oleandrinum |  Oleandrin(um, i n
olearius |  olearius, a, um
oleaster |  oleaster, tri m
olecranon |  olecranon, i n
Olemorphocyclinum |  Olemorphocyclin(um, i n
olens |  olens, entis
oleo |  oleo, ui, --, ere
Oletetrinum |  Oletetrin(um, i n
oleum |  oleum, i n
olfacio |  olfacio, feci, factum, ere
olfactorius |  olfactorius, a, um анат.
olfactus |  olfactus, us m
olidus |  olidus, a, um
oligocytaemia |  oligocytaemia, ae f
oligodactylia |  oligodactylia, ae f
oligodentia |  oligodentia, ae f
oligokinesia |  oligokinesia, ae f
oligomenorrhoea |  oligomenorrhoea, ae f
Oligonervidae |  Oligonervidae, arum f
oligophrenia |  oligophrenia, ae f
oligotrichus |  oligotrichus, a, um биолог.
oliguria |  oliguria, ae f
olim |  olim adv.
olitor |  olitor, oris m
Olitorisidum |  Olitorisid(um, i n
olitorius |  olitorius, a, um
oliva |  oliva, ae f
olivaris |  olivaris, e
olivetum |  olivetum, i n
olivifer |  olivifer, era, erum
olivocerebellaris |  olivocerebellaris, e анат.
Olivomycinum |  Olivomycin(um, i n
olivospinalis |  olivospinalis, e анат.
olivum |  olivum, i n
olla |  olla, ae f
ollus |  ollus, a, um арх.
olor |  olor, oris m
olorinus |  olorinus, a, um
olus |  olus, eris n
olusculum |  olusculum, i n
Olympia |  Olympia, ae f
Olympias |  Olympias, adis f
Olympicus |  Olympicus, a, um
Olympus |  Olympus (-os), i m
Omainum |  Omain(um, i n
omasum |  omasum, i n
Omcilonum |  Omcilon(um, i n
omen |  omen, inis n
omentalis |  omentalis, e анат.
omentum |  omentum, i n
Omephinum |  Omephin(um, i n
Omerilum |  Omeril(um, i n
ominor |  ominor, atus sum, ari
omitto |  omitto, misi, missum, ere
omnigena |  omnigena, ae m
omnino |  omnino adv.
omniparens |  omniparens, entis
omnipotens |  omnipotens, entis
omnis |  omnis, e
Omnoponum |  Omnopon(um, i n
omoclavicularis |  omoclavicularis, e анат.
omohyoideus |  omohyoideus, a, um анат.
omphaloentericus |  omphaloentericus, a, um анат.
omphalomesentericus |  omphalomesentericus, a, um анат.
omphalus |  omphalus, i m
onager |  onager, gri m
onagrus |  onagrus, i m
oncogenesis |  oncogenesis, is f
oncologia |  oncologia, ae f
oncologus |  oncologus, i m
Oncovinum |  Oncovin(um, i n
oneraria |  oneraria, ae f
onerarius |  onerarius, a, um
onero |  onero, avi, atum, are поэт.
onerosus |  onerosus, a, um
ontogenesis |  ontogenesis, is f
ontogeneticus |  ontogeneticus, a, um биолог.
onus |  onus, eris n
onustus |  onustus, a, um
Onycholysinum |  Onycholysin(um, i n
onyx |  onyx, ychis m
oophoron |  oophoron, i n
oophorus |  oophorus, a, um анат.
opaco |  opaco, avi, atum, are
opacus |  opacus, a, um поэт.
opella |  opella, ae f
opera |  opera, ae f
operarius |  operarius, i m
operculum |  operculum, i n
operimentum |  operimentum, i n
operio |  operio, perui, pertum, ire
operior |  operior, --, iri
operor |  operor, atus sum, ari
operose |  operose adv.
operosus |  operosus, a, um
opertum |  opertum, i n
opes |  opes, um см.
Ophthalimidum |  Ophthalimid(um, i n
ophthalmicus |  ophthalmicus, a, um анат.
ophthalmologia |  ophthalmologia, ae f
ophthalmologus |  ophthalmologus, i m
Ophthalmolum |  Ophthalmol(um, i n
ophthalmoplegia |  ophthalmoplegia, ae f
ophthalmorrhagia |  ophthalmorrhagia, ae f
ophthalmorrhexis |  ophthalmorrhexis, is f
ophthalmoscopia |  ophthalmoscopia, ae f
Opialum |  Opial(um, i n
opifer |  opifer, era, erum
opifex |  opifex, icis m
opilio |  opilio (upilio), onis m
opimus |  opimus, a, um
opinatus |  I opinatus, a, um
opinio |  opinio, onis f
opinor |  opinor, atus sum, ari
Opipramolum |  Opipramol(um, i n
opitulor |  opitulor, atus sum, ari
Opium |  Opium, i n
oportet |  oportet, uit, --, ere impers.
oppedo |  oppedo, --, --, ere
opperior |  opperior, peritus (pertus) sum, iri
oppeto |  oppeto, ivi (ii), itum, ere
oppidanus |  I oppidanus, a, um m
oppido |  oppido adv.
oppidulum |  oppidulum, i n
oppidum |  oppidum, i n
oppignero |  oppignero, avi, atum, are
oppilo |  oppilo, (avi), atum, are
oppleo |  oppleo, plevi, pletum, ere
oppono |  oppono, posui, positum, ere
opportune |  opportune adv.
opportunitas |  opportunitas, atis f
opportunus |  opportunus, a, um
oppositus |  I oppositus, (us) sg.
oppressio |  oppressio, onis f
opprimo |  opprimo, pressi, pressum, ere
opprobrium |  opprobrium, i n
oppugnatio |  oppugnatio, onis f
oppugnator |  oppugnator, oris m
oppugno |  oppugno, avi, atum, are
ops |  I ops, opis f
opson |  opson...
optabilis |  optabilis, e
optatio |  optatio, onis f
optativus |  optativus, a, um
optato |  optato adv.
optatum |  optatum, i n
optatus |  optatus, a, um
opticus |  opticus, a, um анат.
optimas |  I optimas, atis m
optime |  optime adv.
optimus |  optimus, a, um superl.
Optinoxanum |  Optinoxan(um, i n
optio |  I optio, onis f
optivus |  optivus, a, um
opto |  opto, avi, atum, are
Optokainum |  Optokain(um, i n
optume |  optume
optumus |  optumus, a, um
opulens |  opulens, entis
opulenter |  opulenter adv.
opulentia |  opulentia, ae f
opulento |  opulento, --, --, are
opulentus |  opulentus, a, um
opus |  I opus n
opusculum |  opusculum, i n
ora |  I ora, ae f
Orabeticum |  Orabetic(um, i n
Orabetum |  Orabet(um, i n
Oracillinum |  Oracillin(um, i n
oraculum |  oraculum, i n
Oradexonum |  Oradexon(um, i n
Oradianum |  Oradian(um, i n
Oradiolum |  Oradiol(um, i n
Oradonum |  Oradon(um, i n
oralis |  oralis, e анат.
Oralutonum |  Oraluton(um, i n
Oranilum |  Oranil(um, i n
orarium |  orarium, i n
Orarsanum |  Orarsan(um, i n
oratio |  oratio, onis f
oratiuncula |  oratiuncula, ae f
orator |  orator, oris m
oratorius |  oratorius, a, um
Oratrenum |  Oratren(um, i n
oratus |  oratus, us m
Oravironum |  Oraviron(um, i n
orba |  orba, ae f
orbator |  orbator, oris m
orbicularis |  orbicularis, e анат.
orbiculus |  orbiculus, i m
orbis |  orbis, is m
orbita |  orbita, ae f
orbitalis |  orbitalis, e
orbitas |  orbitas, atis f
orbitoorbicularis |  orbitoorbicularis, e анат.
orbo |  orbo, avi, atum, are
orbus |  I orbus, a, um m
orca |  orca, ae f
orchas |  orchas, adis f
orchis |  orchis, is m
Orchomenos |  Orchomenos (-us), i m
Orcus |  Orcus, i m
ordeum |  ordeum
ordinarius |  ordinarius, a, um
ordinatim |  ordinatim adv.
ordinatus |  ordinatus, a, um
ordino |  ordino, avi, atum, are
ordior |  ordior, orsus sum, iri
ordo |  ordo, inis m
Oreas |  Oreas, adis f
Oresanum |  Oresan(um, i n
Orestes |  Orestes, ae (is) m
Orestralynum |  Orestralyn(um, i n
Oreticum |  Oretic(um, i n
organella |  organella, ae f
organismus |  organismus, i m
organon |  organon (organum), i n
organum |  organum, i n
Orgia |  Orgia, orum n
oribata |  oribata, ae m
orichalcum |  orichalcum, i n
oriens |  oriens, entis m
Orientomycinum |  Orientomycin(um, i n
orificium |  orificium, i n
origo |  origo, inis f
Orinasum |  Orinas(um, i n
Orion |  Orion, onis m
orior |  orior, ortus sum, iri part.
oriundus |  oriundus, a, um
ornamentum |  ornamentum, i n
ornate |  ornate adv.
ornatrix |  ornatrix, icis f
ornatus |  I ornatus, a, um m
Ornelenum |  Ornelen(um, i n
ornithophilia |  ornithophilia, ae f
Ornithopoda |  I Ornithopoda, orum n
ornithorhynchus |  ornithorhynchus, a, um биолог.
ornithosporia |  ornithosporia, ae f
orno |  orno, avi, atum, are
ornthophilia |  ornthophilia, ae f
ornus |  ornus, i f
oro |  oro, avi, atum, are
Orosteronum |  Orosteron(um, i n
Orphenadrinum |  Orphenadrin(um, i n
Orpheus |  Orpheus (=Orphe^us), ei (eos) m
orphus |  orphus, i m
orsa |  orsa, orum n
orsus |  orsus, us m
orthocladus |  orthocladus, a, um биолог.
orthodontia |  orthodontia, ae f
orthogenesis |  orthogenesis, is f
orthogenia |  orthogenia, ae f
orthognathia |  orthognathia, ae f
Orthonalum |  Orthonal(um, i n
orthopaedia |  orthopaedia, ae f
orthostachyus |  orthostachyus, a, um биолог.
orthostasis |  orthostasis, is f
ortus |  ortus, us m
Ortygia |  Ortygia, ae f
Orvagilum |  Orvagil(um, i n
Orvarsanum |  Orvarsan(um, i n
Oryzarinum |  Oryzarin(um, i n
os |  I os, oris n
oscen |  oscen, inis m
Osci |  Osci, orum m
oscillum |  I oscillum, i n
oscito |  oscito, --, --, are
oscitor |  oscitor, --, ari
osculatio |  osculatio, onis f
osculor |  osculor, atus sum, ari
osculum |  osculum, i n
Osiris |  Osiris, idis (is) m
Osmosalum |  Osmosal(um, i n
Ossa |  Ossa, ae m
osseus |  osseus, a, um
ossiculum |  ossiculum, i n
ossificatio |  ossificatio, onis f
ostendo |  ostendo, tendi, tentum (tensum), ere воен.
Ostensinum |  Ostensin(um, i n
Ostensolum |  Ostensol(um, i n
ostentatio |  ostentatio, onis f
ostentator |  ostentator, oris m
ostento |  ostento, avi, atum, are
ostentum |  ostentum, i n
ostentus |  ostentus, us m
osteoblastus |  osteoblastus, i f
osteocranium |  osteocranium, i n
osteodysplasia |  osteodysplasia, ae f
osteogenesis |  osteogenesis, is f
osteoideus |  osteoideus, a, um анат.
osteoklastus |  osteoklastus, i m
osteologia |  osteologia, ae f
osteolysis |  osteolysis, is f
osteoma |  osteoma, atis n
osteomyelitis |  osteomyelitis, idis f
osteon |  osteon, i n
osteonecrosis |  osteonecrosis, is f
osteonum |  osteonum, i n
osteopathia |  osteopathia, ae f
osteoplastica |  osteoplastica, ae f
osteoplasticus |  osteoplasticus, a, um мед.
osteosclerosis |  osteosclerosis, is f
osteotomia |  osteotomia, ae f
Ostia |  Ostia, ae f
ostiarium |  ostiarium, i n
ostiatim |  ostiatim adv.
ostium |  ostium, i n
Ostralum |  Ostral(um, i n
ostrea |  ostrea, ae f
ostreum |  ostreum, i n
ostrifer |  ostrifer, era, erum
ostrum |  ostrum, i n
Oterbenum |  Oterben(um, i n
Otho |  Otho, onis m
otior |  otior, atus sum, ari
otiose |  otiose adv.
otiosus |  otiosus, a, um
otium |  otium, i n
Otofuralum |  Otofural(um, i n
otogenus |  otogenus, a, um мед.
otolaryngologia |  otolaryngologia, ae f
otolaryngologus |  otolaryngologus, i m
otorhinolaryngologia |  otorhinolaryngologia, ae f
otorrhagia |  otorrhagia, ae f
otorrhoea |  otorrhoea, ae f
otoscopia |  otoscopia, ae f
Otrivenum |  Otriven(um, i n
Oubainum |  Oubain(um, i n
ovatio |  ovatio, onis f
ovatus |  ovatus, a, um биолог.
Ovidius |  Ovidius, a, um
ovile |  ovile, is n
ovillus |  ovillus, a, um
ovis |  ovis, is f
ovo |  ovo, --, --, are
Ovoаflavinum |  Ovoаflavin(um, i n
ovum |  ovum, i n
Oxamycinum |  Oxamycin(um, i n
Oxaphenamidum |  Oxaphenamid(um, i n
Oxazepamum |  Oxazepam(um, i n
Oxazimedrinum |  Oxazimedrin(um, i n
Oxazocillinum |  Oxazocillin(um, i n
Oxazylum |  Oxazyl(um, i n
Oxolinum |  Oxolin(um, i n
Oxsoralenum |  Oxsoralen(um, i n
Oxurazinum |  Oxurazin(um, i n
Oxus |  Oxus (-os), i m
Oxychloroquinum |  Oxychloroquin(um, i n
Oxycholinum |  Oxycholin(um, i n
Oxycnlorochinum |  Oxycnlorochin(um, i n
Oxycoccus |  Oxycoccus, i m
Oxycodonum |  Oxycodon(um, i n
Oxycortum |  Oxycort(um, i n
Oxydigitoxinum |  Oxydigitoxin(um, i n
oxydum |  oxydum, i n
oxygala |  oxygala, ae f
oxyhaemoglobinum |  oxyhaemoglobinum, i n
Oxylidinum |  I Oxylidin(um, i n
Oxypipum |  Oxypip(um, i n
Oxyritinum |  Oxyritin(um, i n
Oxystyptinum |  Oxystyptin(um, i n
Oxytocinum |  Oxytocin(um, i n
Oxyzinum |  Oxyzin(um, i n
Oxyzonum |  Oxyzon(um, i n
Ozokeritum |  Ozokerit(um, i n
