Pabestrolum |  Pabestrol(um, i n
pabulatio |  pabulatio, onis f
pabulator |  pabulator, oris m
pabulor |  pabulor, atus sum, ari
pabulum |  pabulum, i n
pacalis |  pacalis, e
pacata |  pacata, orum n
Pacatalum |  Pacatal(um, i n
pacatus |  pacatus, a, um
Pachycarpinum |  Pachycarpin(um, i n
pachycarpus |  pachycarpus, a, um биолог.
pachymeninx |  pachymeninx, ingis f
pacifer |  pacifer, era, erum
pacificatio |  pacificatio, onis f
pacificator |  pacificator, oris m
pacificatorius |  pacificatorius, a, um
pacifico |  pacifico, avi, atum, are
pacificor |  pacificor, atus sum, ari
pacificus |  pacificus, a, um
Pacinolum |  Pacinol(um, i n
Pacinonum |  Pacinon(um, i n
paciscor |  paciscor, pactus sum, pacisci
Pacitrinum |  Pacitrin(um, i n
paco |  paco, avi, atum, are
pacta |  pacta, ae f
pactio |  pactio, onis f
pactor |  pactor, oris m
pactum |  pactum, i n
pactus |  pactus, a, um
Pacuvius |  Pacuvius, i m
Padicorum |  Padicor(um, i n
Padus |  I Padus, i f
Padutinum |  Padutin(um, i n
paean |  I paean, anis m
paedagogus |  paedagogus, i m
paediater |  paediater, tri m
paediatria |  paediatria, ae f
paedor |  paedor, oris m
paelex |  paelex, icis f
paelicatus |  paelicatus, us m
paene |  paene adv.
paeninsula |  paeninsula, ae f
paenit |  paenit...
paenula |  paenula, ae f
paenulatus |  paenulatus, a, um
paenuria |  paenuria, ae f
paeon |  paeon, onis m
paetulus |  paetulus, a, um
paetus |  paetus, a, um
paganus |  I paganus, a, um m
pagella |  pagella, ae f
pagina |  pagina, ae f
paginula |  paginula, ae f
pagus |  pagus, i m
pala |  pala, ae f
Palacrinum |  Palacrin(um, i n
palaestra |  palaestra, ae f
palaestrice |  palaestrice adv.
palaestricus |  palaestricus, a, um
palaestrita |  palaestrita, ae m
palam |  I palam adv.
Palatinus |  I Palatinus, a, um анат.
Palatium |  Palatium, i n
palatoethmoidalis |  palatoethmoidalis, e анат.
palatoglossus |  palatoglossus, a, um анат.
palatomaxillaris |  palatomaxillaris, e анат.
palatopharyngeus |  palatopharyngeus, a, um анат.
palatovaginalis |  palatovaginalis, e анат.
palatum |  palatum, i n
palatus |  palatus, i m
palea |  palea, ae f
palear |  palear, aris n
paleencephalon |  paleencephalon, i n
paleocerebellum |  paleocerebellum, i n
paleocortex |  paleocortex, icis f
Palerolum |  Palerol(um, i n
Pales |  Pales, is f
Palfium |  Palfium, i n
palimpsestus |  palimpsestus, i m
Palinum |  Palin(um, i n
paliurus |  paliurus, i m
palla |  palla, ae f
Palladium |  Palladium, i n
Pallas |  I Pallas, adis (ados) f
pallens |  pallens, entis
palleo |  palleo, pallui, --, ere поэт.
pallesco |  pallesco, pallui, --, ere поэт.
palliatus |  palliatus, a, um
Pallicidum |  Pallicid(um, i n
pallidothalamicus |  pallidothalamicus, a, um анат.
pallidus |  pallidus, a, um
palliolum |  palliolum, i n
pallium |  pallium, i n
pallor |  pallor, oris m
palma |  palma, ae f
palmaris |  palmaris, e анат.
palmatus |  palmatus, a, um анат.
palmes |  palmes, itis m
palmetum |  palmetum, i n
palmifer |  palmifer, era, erum
palmosus |  palmosus, a, um
palmula |  palmula, ae f
palor |  palor, atus sum, ari
palpatio |  palpatio, onis f
palpebra |  palpebra, ae f
palpebralis |  palpebralis, e анат.
Palphium |  Palphium, i n
palpito |  palpito, avi, atum, are
palpo |  palpo, avi, atum, are
palpor |  palpor, atus sum, ari
paludamentum |  paludamentum, i n
paludatus |  paludatus, a, um
paludosus |  paludosus, a, um
Paludrinum |  Paludrin(um, i n
palumbes |  palumbes, is m
palus |  I palus, i m
Palusilum |  Palusil(um, i n
paluster |  paluster, tris, tre
Pamisylum |  Pamisyl(um, i n
Pamoxanum |  Pamoxan(um, i n
pampineus |  pampineus, a, um
pampiniformis |  pampiniformis, e анат.
pampinus |  pampinus, i m
Pan |  Pan, Panis (Panos) m
panacea |  panacea, ae f
Panadolum |  Panadol(um, i n
panalgia |  panalgia, ae f
Pananginum |  Panangin(um, i n
panaritium |  panaritium, i n
panarthritis |  panarthritis, idis f
Panathenaicus |  Panathenaicus, a, um
Panax |  Panax Ginseng (Shin-seng) фармац.
Pancainum |  Pancain(um, i n
Pancalum |  Pancal(um, i n
pancarditis |  pancarditis, idis f
panchrestus |  panchrestus, a, um
pancreas |  pancreas, atis n
pancreaticoduodenalis |  pancreaticoduodenalis, e анат.
pancreaticolienalis |  pancreaticolienalis, e анат.
pancreaticus |  pancreaticus, a, um анат.
Pancreatinum |  Pancreatin(um, i n
pancreatitis |  pancreatitis, idis f
Pandigalum |  Pandigal(um, i n
pando |  pando, pandi, pansum (passum), ere pass.
pandus |  pandus, a, um
panegyricus |  panegyricus, i m
Panergalum |  Panergal(um, i n
Panflavinum |  Panflavin(um, i n
pango |  pango, pepigi поэт.
Panhexavitum |  Panhexavit(um, i n
panhysterectomia |  panhysterectomia, ae f
panicum |  panicum, i n
panis |  panis, is m
Paniverinum |  Paniverin(um, i n
Pankalma |  Pankalma, ае f
Panmycinum |  Panmycin(um, i n
panniculus |  panniculus, i m
Pannonia |  Pannonia, ae f
pannosus |  pannosus, a, um
pannus |  pannus, i m
Panodormum |  Panodorm(um, i n
Pantalganum |  Pantalgan(um, i n
pantex |  pantex, icis m
panthera |  panthera, ae f
Panthojectum |  Panthoject(um, i n
Pantholinum |  Pantholin(um, i n
Pantocainum |  Pantocain(um, i n
Pantocidum |  Pantocid(um, i n
Pantocrinum |  Pantocrin(um, i n
Pantolaxum |  Pantolax(um, i n
Pantomycinum |  Pantomycin(um, i n
pantophagus |  pantophagus, a, um биолог.
Pantopoda |  Pantopoda, um n
Pantoponum |  Pantopon(um, i n
Pantoseptum |  Pantosept(um, i n
Pantotenum |  Pantoten(um, i n
Pantothaxinum |  Pantothaxin(um, i n
Pantotonum |  Pantoton(um, i n
Pantrypinum |  Pantrypin(um, i n
Panurinum |  Panurin(um, i n
panvasculitis |  panvasculitis, idis f
panzootia |  panzootia, ae f
Papaver |  Papaver, eris n
Papaveratum |  Papaverat(um, i n
papavereus |  papavereus, a, um
Papaverinum |  Papaverin(um, i n
Papazolum |  Papazol(um, i n
Paphlagonia |  Paphlagonia, ae f
Paphos |  Paphos (-us), i m
Paphyllinum |  Paphyllin(um, i n
papilio |  papilio, onis m
papilla |  papilla, ae f
papillaris |  papillaris, e анат.
papula |  papula, ae f
papyraceus |  papyraceus, a, um анат.
papyrifer |  papyrifer, era, erum
papyrus |  papyrus, i m
par |  par, paris subst.
paraaorticus |  paraaorticus, a, um анат.
parabilis |  parabilis, e
Paracainum |  Paracain(um, i n
paracentralis |  paracentralis, e анат.
Paracetamolum |  Paracetamol(um, i n
paracolitis |  paracolitis, idis f
Paracortolum |  Paracortol(um, i n
Paracortum |  Paracort(um, i n
paracystitis |  paracystitis, idis f
paradidymis |  paradidymis, idis f
Paradionum |  Paradion(um, i n
paradoxa |  paradoxa, orum n
paraduodenalis |  paraduodenalis, e анат.
paraffinatus |  paraffinatus, a, um фармац.
Paraffinum |  Paraffinum, i n
Paraflexum |  Paraflex(um, i n
paraflocculus |  paraflocculus, i m
paraganglion |  paraganglion, i n
parahippocampalis |  parahippocampalis, e анат.
Paralestum |  Paralest(um, i n
paralysis |  paralysis, is f
paramastoideus |  paramastoideus, a, um анат.
paramesonephricus |  paramesonephricus, a, um анат.
parametritis |  parametritis, idis f
parametrium |  parametrium, i n
Paramyonum |  Paramyon(um, i n
paranasalis |  I paranasalis, e анат.
parancphritis |  parancphritis, idis f
Paranephrinum |  Paranephrin(um, i n
paranephros |  paranephros, i m
paraneuralis |  paraneuralis, e анат.
paraolivarius |  paraolivarius, a, um анат.
parapancreaticus |  parapancreaticus, a, um анат.
parapharyngealis |  parapharyngealis, e анат.
parapharyngeus |  parapharyngeus, a, um мед.
paraphysis |  paraphysis, is f
parapinealis |  parapinealis, e анат.
paraproctitis |  paraproctitis, idis f
paraproctus |  paraproctus, i m
pararectalis |  pararectalis, e анат.
parasacralis |  parasacralis, e анат.
Parasalum |  Parasal(um, i n
Parasanum |  Parasan(um, i n
parasita |  parasita, ae f
parasitus |  parasitus, i m
parasternalis |  parasternalis, e анат.
parasympathicus |  parasympathicus, a, um анат.
parata |  parata, orum n
parate |  parate adv.
paraterminalis |  paraterminalis, e анат.
Parathesinum |  Parathesin(um, i n
Parathormonum |  Parathormon(um, i n
Parathyreocrinum |  Parathyreocrin(um, i n
Parathyreoidinum |  Parathyreoidin(um, i n
parathyroideus |  parathyroideus, a, um
paratio |  paratio, onis f
paratus |  I paratus, a, um m
paratyphus |  paratyphus, i m
paraumbilicalis |  paraumbilicalis, e анат.
paraurethralis |  paraurethralis, e анат.
paravaginalis |  paravaginalis, e анат.
paraventricularis |  paraventricularis, e анат.
paravertebralis |  paravertebralis, e анат.
Paraxinum |  Paraxin(um, i n
Parazinum |  Parazin(um, i n
Parazonum |  Parazon(um, i n
Parca |  Parca, ae f
parce |  parce adv.
parco |  parco, peperci (parsi), parcitum (parsum), ere
parcus |  parcus, a, um
Parekinum |  Parekin(um, i n
parenchyma |  parenchyma, atis n
parens |  I parens, entis m
parentalia |  parentalia, ium n
parentalis |  parentalis, e
parenteralis |  parenteralis, e анат.
parentes |  parentes, ium m
parento |  parento, avi, atum, are
pareo |  pareo, ui, itum, ere impers.
Pargitanum |  Pargitan(um, i n
paric |  paric...
paries |  paries, etis m
parietalis |  parietalis, e анат.
parietinae |  parietinae, arum f
parietomastoideus |  parietomastoideus, a, um анат.
parietooccipitalis |  parietooccipitalis, e анат.
parietopontinus |  parietopontinus, a, um анат.
parilis |  parilis, e
pario |  pario, peperi, partum, ere part.
Paris |  Paris, idis m
Parisii |  Parisii, orum m
pariter |  pariter adv.
Parkanum |  Parkan(um, i n
Parkazinum |  Parkazin(um, i n
Parkisanum |  Parkisan(um, i n
Parkopanum |  Parkopan(um, i n
parma |  parma, ae f
parmati |  parmati, orum m
parmatus |  parmatus, a, um
parmula |  parmula, ae f
Parnas |  Parna(s)sos (-us), i m
Parnatum |  Parnat(um, i n
Parnitenum |  Parniten(um, i n
paro |  I paro, (avi), atum, are m
parochus |  parochus, i m
parodontium |  parodontium, i n
parodontopathia |  parodontopathia, ae f
parodontosis |  parodontosis, is f
Parodynum |  Parodyn(um, i n
paroecia |  paroecia, ae f
Paromomycinum |  Paromomycin(um, i n
paroophoron |  paroophoron, i n
Paros |  Paros (-us), i f
parotideomassetericus |  parotideomassetericus, a, um анат.
parotideus |  parotideus, а, um
parotis |  parotis, idis f
paroxysmalis |  paroxysmalis, e мед.
parra |  parra, ae f
parricida |  parricida, ae m
parricidium |  parricidium, i n
pars |  I pars, partis f
Parsidolum |  Parsidol(um, i n
parsimonia |  parsimonia, ae f
Parstelinum |  Parstelin(um, i n
parta |  parta, orum n
Parthenon |  Parthenon, onis m
Parthenope |  Parthenope, es f
Parthi |  Parthi, orum m
partialis |  partialis, e
particeps |  particeps, cipis
participo |  participo, avi, atum, are
particula |  particula, ae f
partim |  partim см.
partio |  partio, ivi (ii), itum, ire
partior |  partior, itus sum, iri
partite |  partite adv.
partitio |  partitio, onis f
parturio |  parturio, ivi (ii), --, ire поэт.
partus |  partus, us m
parum |  parum adv.
parumper |  parumper adv.
parunculus |  parunculus, i m
parva |  parva, ae f
parvitas |  parvitas, atis f
parvolus |  parvolus, a, um
parvulus |  parvulus (parvolus), a, um
parvum |  parvum, i, n
parvus |  I parvus, a, um compar.
Pasalicylum |  Pasalicyl(um, i n
pasco |  pasco, pavi, pastum, ere
pascor |  pascor, pastus sum, pasci
pascua |  pascua, orum n
pascuus |  pascuus, a, um
Pasiphaa |  Pasiphaa, ae f
Pasomycinum |  Pasomycin(um, i n
passer |  passer, eris m
passerculus |  passerculus, i m
Passiflora |  Passiflora бот.
passim |  passim adv.
passum |  I passum, i n
passus |  I passus, a, um part.
pasta |  pasta, ae f
pastillum |  pastillum, i n
pastillus |  pastillus, i m
Pastinacinum |  Pastinacin(um, i n
pastio |  pastio, onis f
pastor |  pastor, oris m
pastoralis |  pastoralis, e
pastoricius |  pastoricius, a, um
pastorius |  pastorius, a, um
pastus |  pastus, us m
Patavium |  Patavium, i n
patefacio |  patefacio, feci, factum, ere
patefactio |  patefactio, onis f
patefio |  patefio, factus sum, fieri pass.
patella |  patella, ae f
patellaris |  patellaris, e анат.
patena |  patena, ae f
patens |  patens, entis
patenter |  patenter adv.
pateo |  pateo, tui, --, ere,
pater |  pater, tris m
patera |  patera, ae f
paternus |  paternus, a, um поэт.
patesco |  patesco, patui, --, ere
pathogenesis |  pathogenesis, is f
pathogenus |  pathogenus, a, um мед.
pathologia |  pathologia, ae f
pathologicus |  pathologicus, a, um мед.
patibilis |  patibilis, e
patibulum |  patibulum, i n
patiens |  patiens, entis поэт.
patienter |  patienter adv.
patientia |  patientia, ae f
patina |  patina (patena), ae f
patinatio |  patinatio, onis f
patinus |  patinus, i m
patio |  patio, --, --, ere
patior |  patior, passus sum, pati поэт.
patisco |  patisco, --, --, ere
patrator |  patrator, oris m
patria |  patria, ae f
patricia |  patricia, ae f
patricida |  patricida, ae m
patricius |  I patricius, a, um m
patrimonium |  patrimonium, i n
patrimus |  patrimus, a, um
patritus |  patritus, a, um
patrius |  I patrius, a, um
patro |  patro, avi, atum, are
patrocinium |  patrocinium, i n
Patrocles |  Patrocles, is m
patrona |  patrona, ae f
patronus |  patronus, i m
patruelis |  patruelis, e поэт.
patruus |  I patruus, a, um m
patulus |  patulus, a, um
pauca |  pauca, orum n
pauci |  pauci, orum m
pauciflorus |  pauciflorus, a, um биолог.
paucifolius |  paucifolius, a, um биолог.
paucitas |  paucitas, atis f
pauculus |  pauculus, a, um
paucus |  paucus, a, um pl.
paulatim |  paulatim (paullatim) adv.
paulisper |  paulisper (paullisper) adv.
paulo |  paulo adv.
paululum |  I paululum adv.
paululus |  paululus (paullulus), a, um
paulum |  I paulum adv.
paulus |  I paulus (paullus), a, um m
pauper |  pauper, eris поэт.
pauperculus |  pauperculus, a, um
pauperies |  pauperies, ei f
paupero |  paupero, --, --, are
paupertas |  paupertas, atis f
Pausanias |  Pausanias, ae m
pausea |  pausea (pausia), ae f
pavefactus |  pavefactus, a, um
paveo |  paveo, pavi, --, ere
pavesco |  pavesco, --, --, ere
Pavesthesinum |  Pavesthesin(um, i n
pavide |  pavide adv.
pavidus |  I pavidus, a, um
pavimentatus |  pavimentatus, a, um
pavimentum |  pavimentum, i n
pavio |  pavio, ivi, itum, ire
pavito |  pavito, avi, --, are
pavo |  pavo, onis m
pavor |  pavor, oris m
pax |  pax, pacis f
Pecazinum |  Pecazin(um, i n
peccatum |  peccatum, i n
peccatus |  peccatus, us m
pecco |  pecco, avi, atum, are
pecten |  I pecten, inis m
pectinatus |  pectinatus, a, um анат.
pectinealis |  pectinealis, e
pectineus |  pectineus, a, um анат.
pecto |  pecto, pexi, pexum, ere
Pectolum |  Pectol(um, i n
pectoralis |  pectoralis, e анат.
pectus |  pectus, oris n
Pectussinum |  Pectussin(um, i n
pecu |  pecu, us n
pecuaria |  pecuaria, orum n
pecuarius |  I pecuarius, a, um m
peculator |  peculator, oris m
peculatus |  peculatus, us m
peculiaris |  peculiaris, e
peculium |  peculium, i n
pecunia |  pecunia, ae f
pecuniarius |  pecuniarius, a, um
pecuniosus |  pecuniosus, a, um
pecus |  I pecus, oris n
pedalis |  I pedalis, e анат.
pedarius |  pedarius, a, um
pedes |  pedes, itis m
pedester |  pedester, tris, tre
pedetemptim |  pedetemptim
pedetemtim |  pedetemtim (pedetemptim) adv.
pediaeus |  pediaeus, a, um анат.
pedica |  pedica, ae f
pediculus |  pediculus, i m
pedidius |  pedidius, a, um анат.
pedisequa |  pedisequa, ae f
pedisequus |  I pedisequus, a, um m
peditatus |  peditatus, us m
pedo |  pedo, pepedi, peditum, ere
Pedrolonum |  Pedrolon(um, i n
pedum |  pedum, i n
peduncularis |  peduncularis, e анат.
pedunculus |  pedunculus, i m
Peflavitum |  Peflavit(um, i n
pefuro |  pefuro, --, --, ere
Pegasiformes |  Pegasiformes, ium f
Pegasos |  Pegasos (-us), i m
pegma |  pegma, atis n
Pehanormum |  Pehanorm(um, i n
pejero |  pejero, avi, atum, are
pejor |  pejor compar.
pejus |  pejus compar.
pelagus |  pelagus, i n
Pelasgi |  Pelasgi, orum m
Pelazidum |  Pelazid(um, i n
Pelentanum |  Pelentan(um, i n
Peleus |  Peleus (= Pele^us), ei (eos) m
pelex |  pelex
pelicatus |  pelicatus
Pelides |  Pelides, ae m
Pelion |  Pelion, i n
Pella |  Pella, ae f
Pellagraminum |  Pellagramin(um, i n
pellax |  pellax, acis
pellectio |  pellectio, onis f
pellego |  pellego
pellex |  pellex
pellicatus |  pellicatus
pellicio |  pellicio, lexi, lectum, ere
pellicula |  pellicula, ae f
pellis |  pellis, is f
pellitus |  pellitus, a, um
pello |  pello, pepuli, pulsum, ere поэт.
pelluc |  pelluc...
pellucidus |  pellucidus, a, um анат.
Pelminum |  Pelmin(um, i n
Peloidinum |  Peloidin(um, i n
Peloidodestillatum |  Peloidodestillat(um, i n
Peloninum |  Pelonin(um, i n
Peloponnesos |  Peloponnesos (-us), i f
Pelops |  Pelops, opis m
peloris |  peloris, idis f
pelta |  pelta, ae f
peltastae |  peltastae, arum m
pelusia |  pelusia, ae f
pelvinus |  pelvinus, a, um анат.
Pelviranum |  Pelviran(um, i n
pelvis |  pelvis, is f
Pemalinum |  Pemalin(um, i n
pemma |  pemma, ae f
Penadurum |  Penadur(um, i n
penarius |  penarius (penuarius), a, um
penates |  penates, ium m
penatiger |  penatiger, era, erum
Penbritinum |  Penbritin(um, i n
pendeo |  pendeo, pependi, --, ere поэт.
Pendeponum |  Pendepon(um, i n
Pendiomidum |  Pendiomid(um, i n
pendo |  pendo, pependi, pensum, ere
pendulus |  pendulus, a, um поэт.
pene |  pene adv.
Penelopa |  Penelopa, ae f
penes |  penes praep.
Penesterum |  Penester(um, i n
Penethacillinum |  Penethacillin(um, i n
penetrabilis |  penetrabilis, e
penetralia |  penetralia, ium n
penetralis |  penetralis, e
penetro |  penetro, avi, atum, are
penicilli |  penicilli, orum m
Penicillinasum |  Penicillinas(um, i n
Penicillinum |  Penicillin(um, i n
penicillum |  penicillum, i n
penicillus |  penicillus, i m
peniciter |  peniciter adv.
Peninnus |  Peninnus, a, um
peninsula |  peninsula, ae f
Peninus |  Peninus, a, um
penis |  penis, is m
penitus |  penitus adv.
penna |  penna, ae f
pennatus |  pennatus, a, um
penniformis |  penniformis, e
penniger |  penniger, era, erum
pennula |  pennula, ae f
pensilis |  pensilis, e
pensio |  pensio, onis f
pensito |  pensito, avi, atum, are
penso |  penso, avi, atum, are
Penstaphocidum |  Penstaphocid(um, i n
pensum |  pensum, i n
pensus |  pensus, a, um
Pentabismolum |  Pentabismol(um, i n
Pentacidum |  Pentacid(um, i n
Pentacinum |  Pentacin(um, i n
pentadactylus |  pentadactylus, a, um биолог.
Pentafinum |  Pentafin(um, i n
Pentalginum |  Pentalgin(um, i n
Pentalongum |  Pentalong(um, i n
Pentalum |  Pental(um, i n
Pentamethazenum |  Pentamethazen(um, i n
Pentamethazolum |  Pentamethazol(um, i n
Pentamethonum |  Pentamethon(um, i n
Pentaminum |  Pentamin(um, i n
Pentamylonum |  Pentamylon(um, i n
Pentanitritum |  Pentanitrit(um, i n
Pentanitrolum |  Pentanitrol(um, i n
pentaradialis |  pentaradialis, e биолог.
Pentarylum |  Pentaryl(um, i n
Pentarytum |  Pentaryt(um, i n
Pentavitolum |  Pentavitol(um, i n
Pentazolum |  Pentazol(um, i n
Pentetrazolum |  Pentetrazol(um, i n
Penthranum |  Penthran(um, i n
Pentilenum |  Pentilen(um, i n
Pentitratum |  Pentitrat(um, i n
Pentonum |  Penton(um, i n
Pentovitum |  Pentovit(um, i n
Pentoxylum |  Pentoxyl(um, i n
Pentoxyverinum |  Pentoxyverin(um, i n
Pentralum |  Pentral(um, i n
Pentranum |  Pentran(um, i n
Pentrazolum |  Pentrazol(um, i n
Pentrexum |  Pentrex(um, i n
Pentrexylum |  Pentrexyl(um, i n
Pentritolum |  Pentritol(um, i n
Pentritta |  Pentritta, ae f
Pentylentetrazolum |  Pentylentetrazol(um, i n
Pentylum |  Pentyl(um, i n
penul |  penul...
penuria |  penuria, ae f
penus |  I penus, oris n
peplum |  peplum, i n
peplus |  peplus, i m
Pepsacidum |  Pepsacid(um, i n
Pepsaminum |  Pepsamin(um, i n
Pepsinum |  Pepsin(um, i n
Pepulsanum |  Pepulsan(um, i n
per |  per praep.
pera |  pera, ae f
perabsurdus |  perabsurdus, a, um
peraccommodatus |  peraccommodatus, a, um
peracer |  peracer, cris, cre
peracerbus |  peracerbus, a, um
Peraconum |  Peracon(um, i n
peractio |  peractio, onis f
peracute |  peracute adv.
peracutus |  peracutus, a, um
peradolescens |  peradolescens, entis m
peradolescentulus |  peradolescentulus, i m
peradpositus |  peradpositus, a, um
peraeque |  peraeque adv.
peragito |  peragito, avi, atum, arc
Peragitum |  Peragit(um, i n
perago |  perago, egi, actum, ere юр.
peragratio |  peragratio, onis f
peragro |  peragro, avi, atum, are
peramans |  peramans, antis
peramanter |  peramanter adv.
perambulo |  perambulo, avi, atum, are поэт.
peramoenus |  peramoenus, a, um
peramplus |  peramplus, a, um
Perandrenum |  Perandren(um, i n
peranguste |  peranguste adv.
perangustus |  perangustus, a, um
perantiquus |  perantiquus, a, um
perappositus |  perappositus, a, um
perarduus |  perarduus, a, um
perargutus |  perargutus, a, um
perarmatus |  perarmatus, a, um
peraro |  peraro, avi, atum, are поэт.
perattente |  perattente adv.
perattentus |  perattentus, a, um
perbacchor |  perbacchor, atus sum, ari
perbeatus |  perbeatus, a, um
perbelle |  perbelle adv.
perbene |  perbene adv.
perbenevolus |  perbenevolus, a, um
perbenigne |  perbenigne adv.
perbibo |  perbibo, bibi, --, ere
perblandus |  perblandus, a, um
perbonus |  perbonus, a, um
perbrevis |  perbrevis, e
perbreviter |  perbreviter adv.
perca |  perca, ae f
Percainum |  Percain(um, i n
percalesco |  percalesco, calui, --, ere
percallesco |  percallesco, callui, --, ere
Percaminum |  Percamin(um, i n
percarus |  percarus, a, um
percautus |  percautus, a, um
percelebro |  percelebro, avi, atum, are pass.
perceler |  perceler, is, e
perceleriter |  perceleriter adv.
percello |  percello, culi, culsum, ere
percenseo |  percenseo, censui, --, ere
perceptio |  perceptio, onis f
Perchlorethylenum |  Perchlorethylen(um, i n
percieo |  percieo
percio |  percio, civi, citum, ire
percipio |  percipio, cepi, ceptum, ere pf.
percitus |  percitus, a, um
percolo |  percolo, colui, cultum, ere
percomis |  percomis, e
percommode |  percommode adv.
percommodus |  percommodus, a, um
percontatio |  percontatio, onis f
percontator |  percontator, oris m
percontor |  percontor (percunctor), atus sum, ari
Percortenum |  Percorten(um, i n
percrebresco |  percrebresco (percrebesco), brui (bui), --, ere
percrepo |  percrepo, --, --, are
percunct |  percunct...
percunctor |  percunctor, atus sum, ari
percupidus |  percupidus, a, um
percuriosus |  percuriosus, a, um
percuro |  percuro, avi, atum, are
percurro |  percurro, cucurri (curri), cursum, ere
percursatio |  percursatio, onis f
percursio |  percursio, onis f
percurso |  percurso, --, --, are
percussio |  percussio, onis f
percussor |  percussor, oris m
percussus |  percussus, us m
percutio |  percutio, cussi, cussum, ere
perdifficilis |  perdifficilis, e
perdifficiliter |  perdifficiliter adv.
perdignus |  perdignus, a, um
perdiligens |  perdiligens, entis
perdiligenter |  perdiligenter adv.
perdisco |  perdisco, didici, --, ere pf.
perdiserte |  perdiserte adv.
perdite |  perdite adv.
perditor |  perditor, oris m
perditus |  perditus, a, um
perdiu |  perdiu adv.
perdiuturnus |  perdiuturnus, a, um
perdives |  perdives, itis
perdix |  perdix, icis m
perdo |  perdo, didi, ditum, ere поэт.
perdoceo |  perdoceo, docui, doctum, ere
perdoctus |  perdoctus, a, um
perdoleo |  perdoleo, dolui, --, ere
perdolesco |  perdolesco, dolui, --, ere
perdomo |  perdomo, domui, domitum, are
perduco |  perduco, duxi, ductum, ere поэт.
perductor |  perductor, oris m
perduellio |  perduellio, onis f
perduellis |  perduellis, is m
perduro |  perduro, avi, atum, are
peredo |  peredo, edi, esum, ere
peregre |  peregre adv.
peregrina |  peregrina, ae f
peregrinabundus |  peregrinabundus, a, um
peregrinatio |  peregrinatio, onis f
peregrinator |  peregrinator, oris m
peregrinitas |  peregrinitas, atis f
peregrinor |  peregrinor, atus sum, ari
peregrinus |  I peregrinus, a, um m
perelegans |  perelegans, antis
pereleganter |  pereleganter adv.
pereloquens |  pereloquens, entis
Pereminum |  Peremin(um, i n
peremnis |  peremnis, e
perendie |  perendie adv.
perendinus |  perendinus, a, um
perennis |  perennis, e биолог.
perennitas |  perennitas, atis f
perenno |  perenno, avi, atum, are
pereo |  pereo, ii (редко ivi), itum, ire
perequito |  perequito, avi, atum, are
pererro |  pererro, avi, atum, are
pereruditus |  pereruditus, a, um
perexcelsus |  perexcelsus, a, um
perexigue |  perexigue adv.
perexiguus |  perexiguus, a, um
perfacete |  perfacete adv.
perfacetus |  perfacetus, a, um
perfacile |  perfacile adv.
perfacilis |  perfacilis, e
perfamiliaris |  perfamiliaris, e
perfecte |  perfecte adv.
perfectio |  perfectio, onis f
perfector |  perfector, oris m
perfectus |  perfectus, a, um
perferens |  perferens, entis
perfero |  perfero, tuli, latum, ferre pass.
perficio |  perficio, feci, fectum, ere
perfidelis |  perfidelis, e
perfidia |  perfidia, ae f
perfidiose |  perfidiose adv.
perfidiosus |  perfidiosus, a, um
perfidus |  perfidus, a, um
perflabilis |  perflabilis, e
perflagitiosus |  perflagitiosus, a, um
perflo |  perflo, avi, atum, are
perfodio |  perfodio, fodi, fossum, ere
perforaculum |  perforaculum, i n
perforans |  perforans, antis
perforatio |  perforatio, onis f
perforatus |  perforatus, a, um анат.
perforo |  perforo, avi, atum, are
perfremo |  perfremo, --, --, ere
perfrequens |  perfrequens, entis
perfrico |  perfrico, cui, catnm (ctum), are
perfrigidus |  perfrigidus, a, um
perfringo |  perfringo, fregi, fractum, ere
perfruor |  perfruor, fructus sum, frui
perfuga |  perfuga, ae m
perfugio |  perfugio, fugi, fugitum, ere
perfugium |  perfugium, i n
perfunctio |  perfunctio, onis f
perfundo |  perfundo, fudi, fusum, ere, pass.
perfungor |  perfungor, functus sum, fungi
Pergamum |  Pergamum, i n
pergaudeo |  pergaudeo, --, ere
pergnarus |  pergnarus, a, um
pergo |  pergo, perrexi, perrectum, ere
pergrandis |  pergrandis, e
pergratus |  pergratus, a, um
pergravis |  pergravis, e
pergraviter |  pergraviter adv.
perhibeo |  perhibeo, bui, bitum, ere
perhonorifice |  perhonorifice adv.
perhonorificus |  perhonorificus, a, um
perhorresco |  perhorresco, horrui, --, ere
perhorridus |  perhorridus, a, um
perhumaniter |  perhumaniter adv.
perhumanus |  perhumanus, a, um
Perhydritum |  Perhydrit(um, i n
Perhydrolum |  Perhydrolum, i n
perianalis |  perianalis, e анат.
perianthium |  perianthium, i n
periapicalis |  periapicalis, e анат.
periappendicularis |  periappendicularis, e анат.
periarterialis |  periarterialis, e анат.
periarthritis |  periarthritis, idis f
periarticularis |  periarticularis, e анат.
periauricularis |  periauricularis, e анат.
peribronchialis |  peribronchialis, e анат.
pericardiacophrenicus |  pericardiacophrenicus, a, um анат.
pericarditis |  pericarditis, idis f
pericardium |  pericardium, i n
perichondritis |  perichondritis, idis f
perichondrium |  perichondrium, i n
perichorioidealis |  perichorioidealis, e анат.
Pericles |  Pericles, is m
periclitatio |  periclitatio, onis f
periclitor |  periclitor, atus sum, ari
pericranium |  pericranium, i n
periculose |  periculose adv.
periculosus |  periculosus, a, um
periculum |  periculum, i n
peridoneus |  peridoneus, a, um
perillustris |  perillustris, e
perilympha |  perilympha, ae f
perilymphaticus |  perilymphaticus, a, um анат.
perimbecillus |  perimbecillus, a, um
perimetritis |  perimetritis, idis f
perimetrium |  perimetrium, i n
perimo |  perimo, emi, emptum (emtum), ere pass.
perimotio |  perimotio, onis f
perimysium |  perimysium, i n
perincertus |  perincertus, a, um
perincommode |  perincommode adv.
perincommodus |  perincommodus, a, um
perinde |  perinde adv.
perindulgens |  perindulgens, entis
perinealis |  perinealis, e анат.
perinephritis |  perinephritis, idis f
perineum |  perineum, i n
perineuralis |  perineuralis, e анат.
perineurium |  perineurium, i n
perinfirmus |  perinfirmus, a, um
peringeniosus |  peringeniosus, a, um
periniquus |  periniquus, a, um
perinsignis |  perinsignis, e
perinvisus |  perinvisus, a, um
perinvitus |  perinvitus, a, um
periodontitis |  periodontitis, idis f
periodontium |  periodontium, i n
perionyx |  perionyx, ycis f
periorbita |  periorbita, ae f
periosteum |  periosteum, i n
periostitis |  periostitis, idis f
Peripateticus |  Peripateticus, a, um
peripetasma |  peripetasma, atis n
peripheria |  peripheria, ae f
periphericus |  periphericus, a, um анат.
Periploca |  Periploca, ae f
Periplocinum |  Periplocin(um, i n
periratus |  periratus, a, um
periscelis |  periscelis, idis f
peristroma |  peristroma, atis n
peristylum |  peristylum, i n
perite |  perite adv.
peritendineum |  peritendineum, i n
peritia |  peritia, ae f
peritoneoperinealis |  peritoneoperinealis, e анат.
peritoneum |  peritoneum, i n
peritonitis |  peritonitis, idis f
Peritratum |  Peritrat(um, i n
peritus |  peritus, a, um
perivascularis |  perivascularis, e анат.
periventricularis |  periventricularis, e анат.
perjucunde |  perjucunde adv.
perjucundus |  perjucundus, a, um
perjurium |  perjurium, i n
perjuro |  perjuro, avi, atum, are
perjurus |  perjurus, a, um
perlabor |  perlabor, lapsus sum, labi
perlaetus |  perlaetus, a, um
perlate |  perlate adv.
perlateo |  perlateo, ui, --, ere
perlectio |  perlectio, onis f
perlego |  perlego, legi, lectum, ere
perlevis |  perlevis, e
perleviter |  perleviter adv.
perlibens |  perlibens, entis
perlibenter |  perlibenter adv.
perliberaliter |  perliberaliter adv.
perlicio |  perlicio
perlito |  perlito, avi, atum, are
perlongus |  perlongus, a, um
perluben |  perluben...
perluceo |  perluceo (pelluceo), luxi, --, ere
perlucidus |  perlucidus (pellucidus), a, um
perluctuosus |  perluctuosus, a, um
perluo |  perluo, lui, lutum, ere pass.
perlustro |  perlustro, avi, atum, are
permagnus |  permagnus, a, um
permale |  permale adv.
permanens |  permanens, entis
permaneo |  permaneo, mansi, mansum, ere
permano |  permano, avi, atum, are
permansio |  permansio, onis f
permarinus |  permarinus, a, um
permaturesco |  permaturesco, maturui, --, ere
permediocris |  permediocris, e
permeo |  permeo, avi, atum, are
permetior |  permetior, mensus sum, iri
permingo |  permingo, minxi, --, ere
permirus |  permirus, a, um
permisceo |  permisceo, miscui, mistum (mixtum), ere
permissio |  permissio, onis f
permissum |  permissum, i n
permissus |  permissus, us m
Permitilum |  Permitil(um, i n
permitto |  permitto, misi, missum, ere
permixte |  permixte adv.
permixtim |  permixtim adv.
permixtio |  permixtio, onis f
permoleste |  permoleste adv.
permolestus |  I permolestus, a, um
permolo |  permolo, --, --, ere
permoveo |  permoveo, movi, motum, ere,
permulceo |  permulceo, mulsi, mulsum (mulctum), ere
permulto |  permulto adv.
permultum |  permultum adv.
permultus |  permultus, a, um
permunio |  permunio, ivi, itum, ire
permutatio |  permutatio, onis f
permuto |  permuto, avi, atum, are
perna |  perna, ae f
pernecessarius |  pernecessarius, a, um
pernecesse |  pernecesse adv.
pernego |  pernego, avi, atum, are
perniciabilis |  perniciabilis, e
pernicies |  pernicies, ei f
perniciose |  perniciose adv.
perniciosus |  perniciosus, a, um
pernicitas |  pernicitas, atis f
pernix |  pernix, icis
pernobilis |  pernobilis, e
pernocto |  pernocto, avi, (atum), are
pernosco |  pernosco, novi, --, ere
pernotesco |  pernotesco, notui, --, ere
Pernovinum |  Pernovin(um, i n
pernox |  pernox, octis
pernumero |  pernumero, avi, atum, are
pero |  pero, onis m
perobscurus |  perobscurus, a, um
perodiosus |  perodiosus, a, um
perofficiose |  perofficiose adv.
Perolysenum |  Perolysen(um, i n
peronealis |  peronealis, e анат.
peroneus |  peroneus, a, um
peropportune |  peropportune adv.
peropportunus |  peropportunus, a, um
peroptatus |  peroptatus, a, um
peroratio |  peroratio, onis f
perornatus |  perornatus, a, um
perorno |  perorno, avi, --, are
peroro |  peroro, avi, atum, are
perosus |  perosus, a, um
Perovexum |  Perovex(um, i n
peroxydum |  peroxydum, i n
perparvulus |  perparvulus, a, um
perparvum |  perparvum adv.
perparvus |  perparvus, a, um
perpauculus |  perpauculus, a, um
perpaucus |  perpaucus, a, um
perpaulum |  perpaulum, i n
perpauper |  perpauper, eris
perpello |  perpello, puli, pulsum, ere
perpendicularis |  perpendicularis, e анат.
perpendiculum |  perpendiculum, i n
perpendo |  perpendo, pendi, pensum, ere
perperem |  perperem adv.
perpessio |  perpessio, onis f
perpetior |  perpetior, pessus sum, peti
perpetro |  perpetro, avi, atum, are
perpetuitas |  perpetuitas, atis f
perpetuo |  perpetuo, avi, atum, are
perpetuus |  perpetuus, a, um
Perphenanum |  Perphenan(um, i n
Perphenazinum |  Perphenazin(um, i n
perplaceo |  perplaceo, --, --, ere
perplexe |  perplexe adv.
perplexus |  perplexus, a, um
perpolio |  perpolio, ivi, itum, ire
perpolitus |  perpolitus, a, um
perpopulor |  perpopulor, atus sum, ari
perpotatio |  perpotatio, onis f
perpoto |  perpoto, avi, --, are
perprimo |  perprimo, --, --, ere
perpropinquus |  perpropinquus, a, um
perpugnax |  perpugnax, acis
perpurgo |  perpurgo, avi, atum, are
perpusillus |  perpusillus, a, um
perquam |  perquam adv.
perquiro |  perquiro, sivi, situm, ere
perquisite |  perquisite adv.
perraro |  perraro adv.
perrarus |  perrarus, a, um
perreconditus |  perreconditus, a, um
perridicule |  perridicule adv.
perridiculus |  perridiculus, a, um
perrogatio |  perrogatio, onis f
perrogo |  perrogo, avi, atum, are
perrumpo |  perrumpo, rupi, ruptum, ere
Persae |  Persae, arum m
persaepe |  persaepe adv.
persalse |  persalse adv.
persalsus |  persalsus, a, um
persalutatio |  persalutatio, onis f
persaluto |  persaluto, avi, atum, are
persancte |  persancte adv.
Persantinum |  Persantin(um, i n
persapiens |  persapiens, entis
persapienter |  persapienter adv.
perscienter |  perscienter adv.
perscindo |  perscindo, scidi, scissum, ere
perscitus |  perscitus, a, um
perscribo |  perscribo, scripsi, scriptum, ere
perscriptio |  perscriptio, onis f
perscriptor |  perscriptor, oris m
perscrutor |  perscrutor, atus sum, ari
perseco |  perseco, secui, sectum, are
persedeo |  persedeo (persideo), sedi, sessum, ere
Persedonum |  Persedon(um, i n
persegnis |  persegnis, e
persentio |  persentio, sensi, sensum, ire
Persephone |  Persephone, es f
Persepolis |  Persepolis, is f
persequor |  persequor, secutus (sequutus) sum, sequi юр.
Perses |  Perses, ae m
Perseus |  Perseus (=Perse^us), ei (eos) m
perseverans |  perseverans, antis
perseveranter |  perseveranter adv.
perseverantia |  perseverantia, ae f
persevero |  persevero, avi, atum, are
perseverus |  perseverus, a, um
persideo |  persideo
persido |  persido, sedi, sessum, ere
persigno |  persigno, --, --, are
persimilis |  persimilis, e
persimplex |  persimplex, icis
Persis |  I Persis, idis (idos) f
persisto |  persisto, --, --, ere
persolvo |  persolvo, solvi, solutum, ere
persona |  persona, ae f
personatus |  personatus, a, um
persono |  persono, sonui, sonitum, are
perspectus |  perspectus, a, um
perspergo |  perspergo, --, --, ere
perspicax |  perspicax, acis
perspicientia |  perspicientia, ae f
perspicilia |  perspicilia, ae f
perspicio |  perspicio, spexi, spectum, ere
perspicue |  perspicue adv.
perspicuitas |  perspicuitas, atis f
perspicuus |  perspicuus, a, um
persterno |  persterno, stravi, stratum, ere
perstimulo |  perstimulo, --, --, are
persto |  persto, stiti, (statum), are поэт.
perstringo |  perstringo, strinxi, strictum, ere
perstudiose |  perstudiose adv.
perstudiosus |  perstudiosus, a, um
persuadeo |  persuadeo, suasi, suasum, ere impers.
persuasio |  persuasio, onis f
persuasus |  persuasus, us m
persubtilis |  persubtilis, e
persulto |  persulto, avi, atum, are
pertaedet |  pertaedet, pertaesum est, ere impers.
pertaesus |  pertaesus, a, um
pertempto |  pertempto
pertendo |  pertendo, tendi, --, ere
pertento |  pertento (pertempto), avi, atum, are поэт.
pertenuis |  pertenuis, e
perterebro |  perterebro, avi, atum, are
pertergeo |  pertergeo, tersi, tersum, ere
perterreo |  perterreo, terrui, territum, ere
pertexo |  pertexo, texui, textum, ere
Perthidinum |  Perthidin(um, i n
pertica |  pertica, ae f
pertimesco |  pertimesco, timui, --, ere
pertinacia |  pertinacia, ae f
pertinaciter |  pertinaciter adv.
pertinax |  pertinax, acis
pertineo |  pertineo, tinui, --, ere
pertingo |  pertingo, --, --, ere
pertisum |  pertisum (pertaesum) см.
pertractatio |  pertractatio, onis f
pertracto |  pertracto (pertrecto), avi, atum, are
pertraho |  pertraho, traxi, tractum, ere
Pertranquilum |  Pertranquil(um, i n
pertrecto |  pertrecto, --, --, are
pertristis |  pertristis, e
pertumultuose |  pertumultuose adv.
pertundo |  pertundo, tudi, tusum (tunsum), ere
perturbate |  perturbate adv.
perturbatio |  perturbatio, onis f
perturbatus |  perturbatus, a, um
perturbo |  perturbo, avi, atum, are
perturpis |  perturpis, e
Pertussinum |  Pertussin(um, i n
perungo |  perungo, unxi, unctum, ere
perurbanus |  perurbanus, a, um
peruro |  peruro, ussi, ustum, ere
perutilis |  perutilis, e
pervado |  pervado, vasi, vasum, ere
pervagatus |  pervagatus, a, um
pervagor |  pervagor, atus sum, ari
pervagus |  pervagus, a, um
pervarie |  pervarie adv.
pervasto |  pervasto, avi, atum, are
perveho |  perveho, vexi, vectum, ere pass.
pervello |  pervello, velli, --, ere
pervenio |  pervenio, veni, ventum, ire
perverse |  perverse adv.
perversitas |  perversitas, atis f
perversus |  perversus, a, um
perverto |  perverto (pervorto), verti (vorti), versum (vorsum), ere
pervesperi |  pervesperi adv.
pervestigatio |  pervestigatio, onis f
pervestigo |  pervestigo, avi, atum, are
pervetus |  pervetus, eris
pervetustus |  pervetustus, a, um
pervicacia |  pervicacia, ae f
pervicaciter |  pervicaciter adv.
pervicax |  pervicax, acis
pervideo |  pervideo, vidi, visum, ere
pervigeo |  pervigeo, gui, --, ere
pervigil |  pervigil, ilis
pervigilatio |  pervigilatio, onis f
pervigilium |  pervigilium, i n
pervigilo |  pervigilo, avi, atum, are
pervilis |  pervilis, e
pervinco |  pervinco, vici, victum, ere
Pervitinum |  Pervitin(um, i n
pervium |  pervium, i n
pervius |  pervius, a, um
pervolgo |  pervolgo, --, --, are
pervolito |  pervolito, avi, --, are
pervolo |  I pervolo, avi, atum, are
pervoluto |  pervoluto, --, --, are
pervolvo |  pervolvo, volvi, volutum, ere
pervors |  pervors...
pervort |  pervort...
pervulgatus |  pervulgatus, a, um
pervulgo |  pervulgo, avi, atum, are
pes |  pes, pedis m
pessime |  pessime adv.
pessimus |  pessimus, a, um adj.
pessum |  pessum adv.
pestifer |  pestifer, era, erum
pestifere |  pestifere adv.
pestilens |  pestilens, entis
pestilentia |  pestilentia, ae f
pestis |  pestis, is f
petaloideus |  petaloideus, a, um биолог.
petalum |  petalum, i n
petasatus |  petasatus, a, um
petesso |  petesso, --, --, ere
Petidionum |  Petidion(um, i n
Petinimidum |  Petinimid(um, i n
petiolus |  petiolus, i m
petitio |  petitio, onis f
petitor |  petitor, oris m
petiturio |  petiturio, --, --, ire
peto |  peto, ivi (ii), itum, ere юр.
petoritum |  petoritum, i n
petorritum |  petorritum (petoritum), i n
petra |  petra, ae f
Petronius |  Petronius, a, um
petrooccipitalis |  petrooccipitalis, e анат.
petrosquamosus |  petrosquamosus, a, um анат.
petrosus |  petrosus, a, um анат.
petrotympanicus |  petrotympanicus, a, um анат.
petulans |  petulans, antis
petulanter |  petulanter adv.
petulantia |  petulantia, ae f
petulcus |  petulcus, a, um
Peucedaninum |  Peucedanin(um, i n
Pevirosum |  Peviros(um, i n
Pevitonum |  Peviton(um, i n
Phaedra |  Phaedra, ae f
Phaedrus |  Phaedrus, i m
Phaethon |  Phaethon, ontis m
phager |  phager, gri m
phagocytus |  phagocytus, i m
phalanga |  phalanga, ae f
phalangitae |  phalangitae, arum m
phalanx |  phalanx, angis f
phalarica |  phalarica
phalerae |  phalerae, arum f
phaleratus |  phaleratus, a, um
phallus |  phallus, i m
Phanchinonum |  Phanchinon(um, i n
Phanoctalum |  Phanoctal(um, i n
Phanodormum |  Phanodorm(um, i n
Phanquinonum |  Phanquinon(um, i n
Phanquonum |  Phanquon(um, i n
pharetra |  pharetra, ae f
pharetratus |  pharetratus, a, um
pharmaceutria |  pharmaceutria, ae f
pharmacon |  pharmacon, i n
pharmacopola |  pharmacopola, ae m
pharmocopolium |  pharmocopolium, i n
Pharmotalum |  Pharmotal(um, i n
Pharos |  Pharos (-us), i f
Pharsalos |  Pharsalos (-us), i f
pharyngeus |  pharyngeus, a, um анат.
pharyngobasilaris |  pharyngobasilaris, e анат.
pharynx |  pharynx, yngis m
phaselus |  phaselus (phaselos), i m
Phasis |  Phasis, idis (idos) m
Phenacetinum |  Phenacetin(um, i n
Phenaconum |  Phenacon(um, i n
Phenadonum |  Phenadon(um, i n
Phenalginum |  Phenalgin(um, i n
Phenaloinum |  Phenaloin(um, i n
Phenasalum |  Phenasal(um, i n
Phenatinum |  Phenatin(um, i n
Phenazonum |  Phenazon(um, i n
Phenedinum |  Phenedin(um, i n
Phenemalum |  Phenemal(um, i n
Phenerganum |  Phenergan(um, i n
Phenetamidum |  Phenetamid(um, i n
Phenforminum |  Phenformin(um, i n
Phenindaminum |  Phenindamin(um, i n
Phenindionum |  Phenindion(um, i n
Pheninum |  Phenin(um, i n
Pheniodolum |  Pheniodol(um, i n
Phenmetralinum |  Phenmetralin(um, i n
Phenmetrazinum |  Phenmetrazin(um, i n
Phenobarbitalum |  Phenobarbital(um, i n
Phenobarbitonum |  Phenobarbiton(um, i n
Phenobolinum |  Phenobolin(um, i n
Phenocillinum |  Phenocillin(um, i n
Phenolphthaleinum |  Phenolphthalein(um, i n
Phenolum |  Phenol(um, i n
Phenophanum |  Phenophan(um, i n
Phenopyrinum |  Phenopyrin(um, i n
Phenoquinum |  Phenoquin(um, i n
Phenoxazolum |  Phenoxazol(um, i n
Phenoxymethylpenicillinum |  Phenoxymethylpenicillin(um, i n
Phentanylum |  Phentanyl(um, i n
Phentolaminum |  Phentolamin(um, i n
Phenylbutazonum |  Phenylbutazon(um, i n
Phenylephrinum |  Phenylephrin(um, i n
Phenylindandionum |  Phenylindandion(um, i n
Phenylinum |  Phenylin(um, i n
Phenylonum |  Phenylon(um, i n
Phenytoinum |  Phenytoin(um, i n
Phepranonum |  Phepranon(um, i n
Phethanolum |  Phethanol(um, i n
Phidias |  Phidias, ae m
Philemon |  Philemo(n), monis m
Philippi |  Philippi, orum m
Philippus |  Philippus, i m
philitia |  philitia, orum n
Philoctetes |  Philoctetes, ae m
Philodormum |  Philodorm(um, i n
philologia |  philologia, ae f
philologus |  philologus, i m
Philopotamus |  Philopotamus, i m
philosopha |  philosopha, ae f
philosophe |  philosophe adv.
philosophia |  philosophia, ae f
philosophor |  philosophor, atus sum, ari
philosophus |  I philosophus, a, um m
philtrum |  I philtrum, i n
philura |  philura, ae f
philyra |  philyra (philura), ae f
phimus |  phimus, i m
phlebogramma |  phlebogramma, atis n
phlebographia |  phlebographia, ae f
phlebolithus |  phlebolithus, i m
phlebolysis |  phlebolysis, is f
phlebotomia |  phlebotomia, ae f
phlebs |  phlebs, phlebos n
phlegmone |  phlegmone, es f
phlegmonosus |  phlegmonosus, a, um мед.
Phobexum |  Phobex(um, i n
phoca |  phoca, ae f
Phocaea |  Phocaea, ae f
phoce |  phoce, es f
Phocis |  Phocis, idis (idos) f
Phoebe |  Phoebe, es f
Phoebus |  Phoebus, i m
Phoenix |  I Phoenix, icis m
phonocaseta |  phonocaseta, ae f
Phosphacolum |  Phosphacol(um, i n
phosphas |  phosphas, atis m
Phosphoestrolum |  Phosphoestrol(um, i n
Phosphorus |  Phosphorus, i m
Phosphothiaminum |  Phosphothiamin(um, i n
Phosphrenum |  Phosphren(um, i n
photobiologia |  photobiologia, ae f
photophobus |  photophobus, a, um биолог.
photosyntheticus |  photosyntheticus, a, um биолог.
phototrophus |  phototrophus, a, um биолог.
Phrenazolum |  Phrenazol(um, i n
phreneticus |  phreneticus, a, um
phrenicocolicus |  phrenicocolicus, a, um анат.
phrenicolienalis |  phrenicolienalis, e анат.
phrenicopleuralis |  phrenicopleuralis, e анат.
phrenicus |  phrenicus, a, um анат.
Phrenolonum |  Phrenolon(um, i n
Phrixus |  Phrixus, i m
Phryges |  Phryges, um m
Phrygia |  Phrygia, ae f
Phthalazolum |  Phthalazol(um, i n
Phthazinum |  Phthazin(um, i n
Phthia |  Phthia, ae f
phthisiater |  phthisiater, tri m
phthisiatria |  phthisiatria, ae f
Phthivazidum |  Phthivazid(um, i n
Phthoracizinum |  Phthoracizin(um, i n
Phthorafurum |  Phthorafur(um, i n
Phthorbenzotephum |  Phthorbenzoteph(um, i n
Phthorocortum |  Phthorocort(um, i n
Phthorothanum |  Phthorothan(um, i n
Phthoruracilum |  Phthoruracil(um, i n
Phuturinum |  Phuturin(um, i n
phylarchus |  phylarchus, i m
phyllophyton |  phyllophyton, i n
Phyllopoda |  Phyllopoda, orum n
phylogenesis |  phylogenesis, is f
physica |  I physica, ae f
physicalis |  physicalis, e мед.
physice |  physice adv.
physicus |  I physicus, a, um m
physiognomon |  physiognomon, onis m
physiologia |  physiologia, ae f
physiologicus |  physiologicus, a, um мед.
physiologus |  physiologus, i m
physiotherapia |  physiotherapia, ae f
Physolactinum |  Physolactin(um, i n
Phytinum |  Phytin(um, i n
Phytoferolum |  Phytoferol(um, i n
Phytoferrolactolum |  Phytoferrolactol(um, i n
Phytomelinum |  Phytomelin(um, i n
phytoncida |  phytoncida, orum n
phytophagus |  phytophagus, i m
phytotrophus |  phytotrophus, a, um биолог.
piabilis |  piabilis, e
piacularia |  piacularia, ium n
piacularis |  piacularis, e
piaculum |  piaculum, i n
piamen |  piamen, inis n
pica |  pica, ae f
picaria |  picaria, ae f
picea |  picea, ae f
Picenum |  Picenum, i n
piceus |  piceus, a, um
pico |  pico, avi, atum, are
Picoides |  Picoides, is m
Pictones |  Pictones, um m
pictor |  pictor, oris m
pictura |  pictura, ae f
picturatus |  picturatus, a, um
pictus |  pictus, a, um
picus |  picus, i m
pie |  pie adv.
pietas |  pietas, atis f
piger |  piger, gra, grum
piget |  piget, uit (itum est), ere преим.
pigmentarius |  pigmentarius, i m
pigmentum |  pigmentum, i n
pignerator |  pignerator, oris m
pignero |  pignero, avi, atum, are
pigneror |  pigneror, atus sum, ari
pignus |  pignus, oris n
pigritia |  pigritia, ae f
pigror |  pigror, --, ari
pila |  I pila, ae f
pilanus |  pilanus, i m
pilatus |  pilatus, a, um
pileatus |  pileatus (pilleatus), a, um
pilentum |  pilentum, i n
pileulus |  pileulus (pilleulus), i m
pileus |  pileus (pilleus), i m
pilleatus |  pilleatus, a, um
pilleol |  pilleol...
pilosus |  pilosus, a, um
pilula |  pilula, ae f
pilum |  pilum, i n
pilus |  I pilus, i m
Pimpinella |  Pimpinella, ae f
pina |  pina (pinna), ae f
Pinabinum |  Pinabin(um, i n
Pindarus |  Pindarus, i m
Pindionum |  Pindion(um, i n
Pindus |  Pindus, i m
pinea |  pinea, ae f
pinealis |  pinealis, e анат.
pinetum |  pinetum, i n
pineus |  pineus, a, um
pingo |  pingo, pinxi, pictum, ere
pingue |  pingue, is n
pinguesco |  pinguesco, --, --, ere
pinguis |  pinguis, e
pinifer |  pinifer, era, erum
pinna |  I pinna, ae f
pinnatus |  pinnatus, a, um
pinniger |  pinniger, era, erum
pinnula |  pinnula (pinula), ae f
pinoteres |  pinoteres, ae m
pinso |  pinso, pinsi (pinsui), pinsum (pinsitum, pistum), ere
Pinus |  Pinus, i f
pinus |  pinus, us f
pio |  pio, avi, atum, are
Piofolinum |  Piofolin(um, i n
Pioxolum |  Pioxol(um, i n
pipa |  pipa, ae f
Pipanolum |  Pipanol(um, i n
piper |  piper, eris n
Piperascatum |  Piperascat(um, i n
Piperazatum |  Piperazat(um, i n
Piperazinum |  Piperazin(um, i n
piperitus |  piperitus, a, um фармац.
Pipolphenum |  Pipolphen(um, i n
Pipradrolum |  Pipradrol(um, i n
Pipralum |  Pipral(um, i n
Piraeus |  Piraeus, i m
Pirasulfonum |  Pirasulfon(um, i n
pirata |  pirata, ae m
piratica |  piratica, ae f
piraticus |  piraticus, a, um
Piridrolum |  Piridrol(um, i n
piriformis |  piriformis, e анат.
Pirilenum |  Pirilen(um, i n
Pirmazinum |  Pirmazin(um, i n
pirum |  pirum, i n
pirus |  pirus, i f
Pirvilum |  Pirvil(um, i n
piscator |  piscator, oris m
piscatorius |  piscatorius, a, um
piscatus |  piscatus, us m
pisciculus |  pisciculus, i m
piscina |  piscina, ae f
piscinarius |  piscinarius, i m
piscis |  piscis, is m
piscor |  piscor, atus sum, ari
piscosus |  piscosus, a, um
pisiformis |  pisiformis, e анат.
Pisistratus |  Pisistratus, i m
pisohamatus |  pisohamatus, a, um анат.
pisometacarpeus |  pisometacarpeus, a, um анат.
pistor |  pistor, oris m
pistrina |  pistrina, ae f
pistrinum |  pistrinum, i n
pistrix |  pistrix, icis f
pisum |  pisum, i n
Pitonum |  Piton(um, i n
Pituglandolum |  Pituglandol(um, i n
Pituiganum |  Pituigan(um, i n
pituitarius |  pituitarius, a, um анат.
pituitosus |  pituitosus, a, um
Pituitrinum |  Pituitrin(um, i n
piuita |  piuita, ae f
pius |  pius, a, um анат.
pix |  pix, picis f
placabilis |  placabilis, e
placabilitas |  placabilitas, atis f
placamen |  placamen, inis n
placamentum |  placamentum, i n
placate |  placate adv.
placatio |  placatio, onis f
placatus |  placatus, a, um
placenta |  I placenta, ae f
placeo |  placeo, ui, itum, ere impers.
placide |  placide adv.
placidus |  placidus, a, um
placitum |  placitum, i n
placitus |  placitus, a, um
placo |  placo, avi, atum, are
plaga |  I plaga, ae f
plagiarius |  plagiarius, i m
plagosus |  plagosus, a, um
plagula |  plagula, ae f
planctus |  planctus, us m
plane |  plane adv.
plango |  plango, planxi, planctum, ere pass.
plangor |  plangor, oris m
planguncula |  planguncula, ae f
planitas |  planitas, atis f
planitia |  planitia, ae f
Planocainum |  Planocain(um, i n
planta |  I planta, ae f
Plantago |  Plantago, inis f
plantaria |  plantaria, ium n
plantaris |  I plantaris, e анат.
planum |  planum, i n
planus |  I planus, a, um m
Plaquenilum |  Plaquenil(um, i n
Plaquinolum |  Plaquinol(um, i n
plasma |  plasma, atis n
Plasmocidum |  Plasmocid(um, i n
Plasmolum |  Plasmol(um, i n
plasticus |  plasticus, a, um анат.
Plataeae |  Plataeae, arum f
platalea |  platalea, ae f
platanus |  platanus, i f
platea |  platea f
Plathelminthes |  Plathelminthes, um f
Platon |  Plato(n), onis m
Platonici |  Platonici, orum m
platurus |  platurus, a, um биолог.
Platydinum |  Platydin(um, i n
Platyphyllinum |  Platyphyllin(um, i n
platyphyllus |  platyphyllus, a, um биолог.
platyrrhinus |  platyrrhinus, a, um биолог.
platysma |  platysma, atis n
plaudo |  plaudo (plodo), plausi (plosi), plausum (plosum), ere
plausibilis |  plausibilis, e
plausor |  plausor, oris m
plaustrum |  plaustrum (plostrum), i n
plausus |  plausus, us m
Plautus |  Plautus, i m
Plavephinum |  Plavephin(um, i n
plebecula |  plebecula, ae f
plebeja |  plebeja, ae f
plebejus |  I plebejus, a, um m
plebes |  plebes, ei f
plebicola |  plebicola, ae m
plebiscitum |  plebiscitum, i n
plebs |  plebs, plebis f
plecto |  plecto, --, --, ere pass.
plectrum |  plectrum, i n
Pleganginum |  Plegangin(um, i n
Plegomazinum |  Plegomazin(um, i n
Pleione |  Pleione, es f
Plejades |  Plejades, adum f
plene |  plene adv.
plenus |  plenus, a, um
pleraeque |  pleraeque см.
plerique |  plerique см.
plerumque |  plerumque adv.
plerusque |  plerusque, plereque, plerumque pl.
pleura |  pleura, ae f
pleuritis |  pleuritis, idis f
pleuroesophageus |  pleuroesophageus, a, um
plexus |  plexus, us m
plica |  plica, ae f
plicatus |  plicatus, a, um анат.
plico |  plico, (avi
Plinius |  Plinius, a, um
plodo |  plodo, ere
ploeres |  ploeres арх.
ploratus |  ploratus, us m
ploro |  ploro, avi, atum, are
plosor |  plosor, oris m
plostellum |  plostellum, i n
plostrum |  plostrum, i n
plosus |  plosus, us m
pluma |  pluma, ae f
plumatus |  plumatus, a, um
plumbeus |  plumbeus, a, um
Plumbum |  Plumbum, i n
plumbum |  plumbum, i n
plumeus |  plumeus, a, um
pluo |  pluo, plui ( арх.
plurimus |  plurimus, a, um см.
plus |  plus, pluris см.
plusculus |  plusculus, a, um
pluteus |  pluteus, i m
Pluton |  Pluto(n), onis m
pluvia |  pluvia, ae f
pluvialis |  pluvialis, e
pluvius |  pluvius, a, um
pneumaticus |  pneumaticus, a, um анат.
pneumatosis |  pneumatosis, is f
pneumolysis |  pneumolysis, is f
pneumonectomia |  pneumonectomia, ae f
pneumonia |  pneumonia, ae f
pneumoperitoneum |  pneumoperitoneum, i n
pneumosclerosis |  pneumosclerosis, is f
pneumothorax |  pneumothorax, acis m
pneumotomia |  pneumotomia, ae f
Poa |  Poa, ae f
pocillum |  pocillum, i n
poculum |  poculum, i n
podagra |  podagra, ae f
podex |  podex, icis m
podocarpus |  podocarpus, a, um биолог.
Podophyllinum |  Podophyllin(um, i n
Podophyllum |  Podophyllum, i n
Poecile |  Poecile, es f
poema |  poema, atis n
poena |  poena, ae f
Poeni |  Poeni, orum m
poenior |  poenior, --, iri
poenitentia |  poenitentia, ae f
poeniteo |  poeniteo (paeniteo), ui, --, ere impers.
poenitio |  poenitio, onis f
Poenus |  Poenus, a, um
poesis |  poesis, is f
poeta |  poeta, ae m
poetica |  poetica, ae f
poetice |  poetice adv.
poeticus |  poeticus a, um
poetria |  poetria, ae f
pol |  pol! interj.
Polamidonum |  Polamidon(um, i n
polaris |  polaris, e анат.
Polcortoionum |  Polcortoion(um, i n
Polcortum |  Polcort(um, i n
Polemonium |  Polemonium, i n
polenta |  polenta, ae f
Polfamycinum |  Polfamycin(um, i n
Polfavenolum |  Polfavenol(um, i n
poliomyelitis |  poliomyelitis, idis f
polite |  polite adv.
politia |  politia, ae f
politicus |  politicus, a, um
politus |  politus, a, um
pollens |  pollens, entis
polleo |  polleo, --, --, ere
pollex |  pollex, icis m
polliceor |  polliceor, citus sum, eri
pollicitatio |  pollicitatio, onis f
pollicitor |  pollicitor, atus sum, ari
pollicitura |  pollicitura, i n
pollo |  pollo, ivi, itum, ire
polluo |  polluo, ui, utum, ere
pollutus |  pollutus, a, um
Pollux |  Pollux, ucis m
Polocainum |  Polocain(um, i n
Polopyrina |  Polopyrina, ae f
polus |  I polus, i m
polyandria |  polyandria, ae f
polyarthralgia |  polyarthralgia, ae f
polyarthritis |  polyarthritis, idis f
polyavitaminosis |  polyavitaminosis, is f
Polybius |  Polybius, i m
Polycidinum |  Polycidin(um, i n
Polycillinum |  Polycillin(um, i n
polycladus |  polycladus, a, um биолог.
polycystosus |  polycystosus, a, um мед.
polydactylia |  polydactylia, ae f
polydactylus |  polydactylus, a, um биолог.
polygamia |  polygamia, ae f
polygamus |  polygamus, a, um биолог.
Polyglucinum |  Polyglucin(um, i n
Polygonum |  Polygonum, i n
polygynia |  polygynia, ae f
Polyhymnia |  Polyhymnia, ae f
Polymerolum |  Polymerol(um, i n
polyneuritis |  polyneuritis, idis f
polyphagia |  polyphagia, ae f
Polyphemos |  Polyphemos (-us), i m
polyphosphas |  polyphosphas, atis m
polyposis |  polyposis, is f
polypterus |  polypterus, a, um биолог.
polypus |  I polypus, i m
polyrrhizus |  polyrrhizus, a, um биолог.
polyuria |  polyuria, ae f
Polyvinylpyrrolidonum |  Polyvinylpyrrolidon(um, i n
polyvitaminicus |  polyvitaminicus, a, um фармац.
polyvitaminosus |  polyvitaminosus, a, um фармац.
polyvitaminum |  polyvitaminum, i n
Polyzimum |  Polyzim(um, i n
pomarium |  pomarium, i n
pomarius |  I pomarius, a, um m
pomatus |  pomatus, a, um
pomeridianus |  pomeridianus (postmeridianus, posmeridianus), a, um
pomerium |  pomerium, i n
pomifer |  pomifer, era, erum
pomoerium |  pomoerium (pomerium), i n
pompa |  pompa, ae f
Pompejani |  Pompejani, orum m
Pompeji |  Pompeji, orum m
Pompejus |  Pompejus (Pompeius), a, um
pompilus |  pompilus, i m
pomum |  pomum, i n
pomus |  pomus, i f
pondero |  pondero, avi, atum, are
ponderosus |  ponderosus, a, um
Pondexum |  Pondex(um, i n
pondo |  pondo
pondus |  pondus, eris n
pone |  I pone adv.
pono |  I pono, posui, positum, ere pass.
ponticulus |  ponticulus, i m
pontifex |  pontifex, icis m
pontificalis |  pontificalis, e
pontificatus |  pontificatus, us m
pontificius |  pontificius, a, um
ponto |  ponto, onis m
pontus |  I pontus, i m
popa |  popa, ae m
popellus |  popellus, i m
popina |  popina, ae f
popino |  popino, onis m
poples |  I poples, itis m
popliteus |  popliteus, a, um анат.
poplus |  poplus, i m
populabilis |  populabilis, e
populabundus |  populabundus, a, um
populares |  populares, ium m
popularis |  I popularis, e m
populariter |  populariter adv.
populatio |  populatio, onis f
populator |  populator, oris m
populeus |  populeus, a, um
populifer |  populifer, era, erum
populiscitum |  populiscitum, i n
populo |  populo, avi, atum, are поэт.
populus |  I populus, i m
porca |  porca, ae f
porcus |  porcus, i m
porgo |  porgo, porxi, --, ere
porrectio |  porrectio, onis f
porrectus |  porrectus, a, um поэт.
porricio |  porricio, --, rectum, ere
porrigo |  I porrigo, inis f
porro |  porro adv.
porrum |  porrum, i n
porta |  porta, ae f
portalis |  portalis, e анат.
portatio |  portatio, onis f
portendo |  portendo, tendi, tentum, ere pass.
portentificus |  portentificus, a, um
portentosus |  portentosus, a, um
portentum |  portentum, i n
porticula |  porticula, ae f
porticus |  porticus, us f
portio |  portio, onis f
portitor |  I portitor, oris m
porto |  porto, avi, atum, are
portocavalis |  portocavalis, e анат.
portorium |  portorium, i n
portula |  portula, ae f
portuosus |  portuosus, a, um
portus |  portus, us m
porus |  porus, i m
posco |  posco, poposci, --, ere pass.
posea |  posea, ae f
Posedrinum |  Posedrin(um, i n
posia |  posia, ae f
positio |  positio, onis f
positor |  positor, oris m
positus |  I positus, a, um m
posmeridianus |  posmeridianus, a, um
possessio |  I possessio, onis f
possessiuncula |  possessiuncula, ae f
possessor |  possessor, oris m
possideo |  possideo, sedi, sessum, ere поэт.
possido |  possido, sedi, sessum, ere
possum |  possum, potui, --, posse
post |  I post adv.
post-hac |  post-hac adv.
post-haec |  post-haec adv.
postcentralis |  postcentralis, e анат.
postea |  postea adv.
posteaquam |  posteaquam conj.
postembryonalis |  postembryonalis, e биолог.
posteri |  posteri, orum m
posterior |  posterior, ius compar.
posteritas |  posteritas, atis f
posterius |  posterius adv.
postero |  postero adv.
posterolateralis |  posterolateralis, e анат.
posteromedialis |  posteromedialis, e анат.
posterus |  posterus, а, um compar.
postfero |  postfero, --, ferre
postgeniti |  postgeniti, orum m
posthabeo |  posthabeo, bui, bitum, ere
posthaemorrhagicus |  posthaemorrhagicus, a, um мед.
posticum |  posticum, i n
posticus |  posticus, a, um
postilio |  postilio, onis f
postis |  postis, is m
postliminium |  postliminium, i n
postmeridianus |  postmeridianus, a, um
postmodo |  postmodo adv.
postmodum |  postmodum adv.
postmoerium |  postmoerium, i n
postnatalis |  postnatalis, e биолог.
postpono |  postpono, posui, positum, ere
postprincipia |  postprincipia, orum n
postquam |  postquam conj.
postremo |  postremo adv.
postremum |  postremum adv.
postremus |  postremus, a, um superl.
postridie |  postridie adv.
postscribo |  postscribo, --, --, ere
postsynapticus |  postsynapticus, a, um биолог.
postulatio |  postulatio, onis f
postulatum |  postulatum, i n
postulatus |  postulatus, us m
postulo |  postulo, avi, atum, are юр.
postumus |  postumus, a, um superl.
postus |  postus, a, um см.
potatio |  potatio, onis f
potens |  potens, entis поэт.
potentatus |  potentatus, us m
potenter |  potenter adv.
potentia |  potentia, ae f
Potentilla |  Potentilla, ae f
potesse |  potesse
potestas |  potestas, atis f
potio |  potio, onis f
potior |  I potior, itus sum, iri compar.
potis |  potis, e compar.
potissimum |  potissimum adv.
potissimus |  potissimus, а, um superl.
potius |  potius adv.
poto |  poto, potavi, potatum (potum), are
potor |  potor, oris m
potulenta |  potulenta, orum n
potulentus |  potulentus, a, um
potus |  I potus, a, um part.
Povanum |  Povan(um, i n
Povanylum |  Povanyl(um, i n
pracjudico |  pracjudico, avi, atum, are
Practololum |  Practolol(um, i n
prae |  prae praep.
praeacutus |  praeacutus, a, um
praealtus |  praealtus, a, um
praebeo |  praebeo, bui, bitum, ere поэт.
praebibo |  praebibo, bibi, --, ere
praebitor |  praebitor, oris m
praecalidus |  praecalidus, a, um
praecanus |  praecanus, a, um
praecaveo |  praecaveo, cavi, cautum, ere
praecedo |  praecedo, cessi, cessum, ere
praecellens |  praecellens, entis
praecello |  praecello, --, --, ere
praecelsus |  praecelsus, a, um
praecentio |  praecentio, onis f
praecento |  praecento, --, --, are
praecentralis |  praecentralis, e биолог.
praeceps |  I praeceps adv.
praeceptio |  praeceptio, onis f
praeceptor |  praeceptor, oris m
praeceptrix |  praeceptrix, icis f
praeceptum |  praeceptum, i n
praecerpo |  praecerpo, cerpsi, cerptum, ere
praecido |  praecido, cidi, cisum, ere
praecingo |  praecingo, cinxi, cinсtum, ere
praecino |  praecino, --, --, ere
praecipio |  praecipio, cepi, ceptum, ere
praecipitatus |  praecipitatus, a, um хим.
praecipito |  praecipito, avi, atum, are поэт.
praecipue |  praecipue adv.
praecipuum |  praecipuum, i n
praecipuus |  praecipuus, a, um
praecise |  praecise adv.
praecisio |  praecisio, onis f
praecisus |  praecisus, a, um
praeclare |  praeclare adv.
praeclarus |  praeclarus, a, um
praecludo |  praecludo, clusi, clusum, ere
praeco |  praeco, onis m
praecogito |  praecogito, avi, atum, are
praecognosco |  praecognosco, cognovi, cognitum, ere
praecolo |  praecolo, colui, cultum, ere
praecompositus |  praecompositus, a, um
praeconium |  praeconium, i n
praeconius |  praeconius, a, um
praeconsumo |  praeconsumo, (consumpsi), consumptum, ere
praecontrecto |  praecontrecto, --, --, are
praecordia |  praecordia, orum n
praecorrumpo |  praecorrumpo, rupi, ruptum, ere
praecurro |  praecurro, cucurri (curri), cursum, ere
praecursio |  praecursio, onis f
praecursor |  praecursor, oris m
praecutio |  praecutio, --, --, ere
praeda |  praeda, ae f
praedabundus |  praedabundus, a, um
praedamno |  praedamno, avi, atum, are
praedatio |  praedatio, onis f
praedator |  praedator, oris m
praedatorius |  praedatorius, a, um
praedelasso |  praedelasso, --, --, are
praedemno |  praedemno, --, --, are
praedestino |  praedestino, avi, atum, are
praediator |  praediator, oris m
praediatorius |  praediatorius, a, um
praedicabilis |  praedicabilis, e
praedicatio |  praedicatio, onis f
praedico |  I praedico, avi, atum, are
praedictio |  praedictio, onis f
praedictum |  praedictum, i n
praediolum |  praediolum, i n
praedisco |  praedisco, didici, --, ere
praedispositus |  praedispositus, a, um
praeditus |  praeditus, a, um
praedium |  praedium, i n
praedives |  praedives, itis
praedo |  praedo, onis m
praedoceo |  praedoceo, (docui), doctum, ere
praedor |  praedor, atus sum, ari
praeduco |  praeduco, duxi, ductum, ere
praedulcis |  praedulcis, e
praedurus |  praedurus, a, um
praeemineo |  praeemineo (praemineo), --, --, ere
praeeo |  praeeo, ivi (ii), itum, ire
praefatio |  praefatio, onis f
praefectura |  praefectura, ae f
praefectus |  I praefectus, a, um part.
praefero |  praefero, tuli, latum, ferre pass.
praeferox |  praeferox, ocis
praefestino |  praefestino, --, --, are
praeficio |  praeficio, feci, fectum, ere
praefidens |  praefidens, entis
praefigo |  praefigo, fixi, fixum, ere
praefinio |  praefinio, ivi (ii), itum, ire
praefloro |  praefloro, avi, atum, are
praefluo |  praefluo, --, --, ere
praefoco |  praefoco, avi, atum, are
praefodio |  praefodio, fodi, fossum, ere
praefor |  praefor, fatus sum, ari поэт.
praefracte |  praefracte adv.
praefractus |  praefractus, a, um
praefrigidus |  praefrigidus, a, um
praefringo |  praefringo, fregi, fractum, ere
praefulcio |  praefulcio, --, --, ire
praefulgeo |  praefulgeo, fulsi, --, ere
praegelidus |  praegelidus, a, um
praegestio |  praegestio, --, --, ire
praegnans |  praegnans, antis
Praegnantolum |  Praegnantol(um, i n
praegnas |  praegnas, atis
Praegninum |  Praegnin(um, i n
praegracilis |  praegracilis, e
praegravis |  praegravis, e
praegravo |  praegravo, avi, atum, are
praegredior |  praegredior, gressus sum, gredi
praegressio |  praegressio, onis f
praegressus |  praegressus, us m
praegustator |  praegustator, oris m
praegusto |  praegusto, avi, atum, are
praejaceo |  praejaceo, --, --, ere
praejudicatum |  praejudicatum, i n
praejudicatus |  praejudicatus, a, um
praejudicium |  praejudicium, i n
praejuvo |  praejuvo, juvi, --, are
praelabor |  praelabor, lapsus sum, labi
praelambo |  praelambo, lambi, --, ere
praelego |  praelego, legi, lectum, ere
praeliator |  praeliator
praeligo |  praeligo, avi, atum, are
praelior |  praelior
praelium |  praelium
praelongus |  praelongus, a, um
praeluceo |  praeluceo, luxi, --, ere
praelum |  praelum, i n
praelustris |  praelustris, e
praemandata |  praemandata, orum n
praemando |  praemando, avi, atum, are
praematurus |  praematurus, a, um
praemedicatus |  praemedicatus, a, um
praemeditatio |  praemeditatio, onis f
praemeditor |  praemeditor, atus sum, ari
praemetuo |  praemetuo, --, --, ere
praemineo |  praemineo
praemitto |  praemitto, misi, missum, ere
praemium |  praemium, i n
praemoenio |  praemoenio
praemolestia |  praemolestia, ae f
praemolior |  praemolior, itus sum, iri
praemoneo |  praemoneo, ui, itum, ere
praemonitus |  praemonitus, us m
praemonstro |  praemonstro, avi, atum, are
praemorior |  praemorior, mortuus sum, mori
praemunio |  praemunio (praemoenio), ivi, itum, ire
praenato |  praenato, --, --, are
Praeneste |  Praeneste, is n
praeniteo |  praeniteo, tui, --, ere
Praenitronum |  Praenitron(um, i n
praenomen |  praenomen, inis n
praenosco |  praenosco, novi, notum, ere
praenotio |  praenotio, onis f
praenubilus |  praenubilus, a, um
praenuntia |  praenuntia, ae f
praenuntio |  praenuntio, avi, atum, are
praenuntius |  I praenuntius, a, um m
praeoccupatio |  praeoccupatio, onis f
praeoccupo |  praeoccupo, avi, atum, are
praeopto |  praeopto, avi, atum, are
praepando |  praepando, --, --, ere
praeparatio |  praeparatio, onis f
praeparatum |  praeparatum, i n
praeparo |  praeparo, avi, atum, are
praepedio |  praepedio, ivi (ii), itum, ire
praependeo |  praependeo, pendi, --, ere
praepes |  praepes, etis
Praephysonum |  Praephyson(um, i n
praepilatus |  praepilatus, a, um
praepinguis |  praepinguis, e
praepolleo |  praepolleo, --, --, ere
praepondero |  praepondero, avi, atum, are
praepono |  praepono, posui, positum, ere
praepositio |  praepositio, onis f
praepostere |  praepostere adv.
praeposterus |  praeposterus, a, um
praepotens |  praepotens, entis
praepropere |  praepropere adv.
praeproperus |  praeproperus, a, um
praequeror |  praequeror, questus sum, queri
praeradio |  praeradio, --, --, are
praerapidus |  praerapidus, a, um
praerigesco |  praerigesco, rigui, --, ere
praeripio |  praeripio, ripui, reptum, ere
praerodo |  praerodo, rosi, rosum, ere
praerogativa |  praerogativa, ae f
praerogativus |  praerogativus, a, um юр.
praerumpo |  praerumpo, rupi, ruptum, ere
praerupta |  praerupta, orum n
praeruptus |  praeruptus, a, um
praes |  praes, praedis m
praesaepe |  praesaepe, is n
praesaepio |  praesaepio, saepsi, saeptum, ire
praesagio |  praesagio, ivi (ii), ire
praesagitio |  praesagitio, onis f
praesagium |  praesagium, i n
praesagus |  praesagus, a, um
praescisco |  praescisco, ivi, --, ere
praescius |  praescius, a, um
praescribo |  praescribo, scripsi, scriptum, ere
praescriptio |  praescriptio, onis f
praescriptum |  praescriptum, i n
praeseco |  praeseco, secui, secatum (sectum), are
praesens |  praesens, entis
praesensio |  praesensio, onis f
praesentia |  praesentia, ae f
praesentio |  praesentio, sensi, sensum, ire
praesep |  praesep...
praesertim |  praesertim adv.
praeses |  I praeses, idis m
praesideo |  praesideo, sedi, sessum, ere
praesidiarius |  praesidiarius, a, um
praesidium |  praesidium, i n
praesignifico |  praesignifico, --, --, are
praesignis |  praesignis, e
praesono |  praesono, sonui, --, are
praestabilis |  praestabilis, e
praestans |  praestans, antis
praestantia |  praestantia, ae f
praestes |  praestes, itis m
praestigator |  praestigator, oris m
praestigiae |  praestigiae, arum f
praestituo |  praestituo, ui, utum, ere
praesto |  I praesto adv.
praestolor |  praestolor, atus sum, ari
praestringo |  praestringo, strinxi, strictum, ere
praestruo |  praestruo, struxi, structum, ere поэт.
praesul |  praesul, ulis
praesultator |  praesultator, oris m
praesulto |  praesulto, --, --, are
praesum |  praesum, fui, --, esse
praesumo |  praesumo, sumpsi, sumptum, ere
praesuo |  praesuo, (sui), sutum, ere поэт.
praetempto |  praetempto
praetendo |  praetendo, tendi, tensum (tentum), ere
praetento |  praetento (praetempto), avi, atum, are
praetepesco |  praetepesco, tepui, --, ere
praeter |  I praeter adv.
praeterago |  praeterago, --, --, ere
praeterea |  praeterea adv.
praetereo |  praetereo, ii (ivi), itum, ire
praeterequito |  praeterequito, --, --, are
praeterfero |  praeterfero, tuli, latum, ferre pass.
praeterfluo |  praeterfluo, --, --, ere
praetergredior |  praetergredior, gressus sum, gredi
praeteritus |  praeteritus, a, um
praeterlabor |  praeterlabor, lapsus sum, labi
praetermissio |  praetermissio, onis f
praetermitto |  praetermitto, misi, missum, ere
praetervectio |  praetervectio, onis f
praetervehor |  praetervehor, vectus sum, vehi
praetervidus |  praetervidus, a, um
praetervolo |  praetervolo, --, --, are
praetexo |  praetexo, texui, textum, ere
praetexta |  praetexta, ae f
praetextatus |  praetextatus, a, um
praetextum |  praetextum, i n
praetextus |  praetextus, us m
praetinctus |  praetinctus, a, um
praetor |  praetor, oris m
praetorianus |  praetorianus, a, um
praetorium |  praetorium, i n
praetorius |  I praetorius, i m
praetura |  praetura, ae f
praeumbro |  praeumbro, --, --, are
praeustus |  praeustus, a, um
praevaleo |  praevaleo, valui, --, ere
praevalidus |  praevalidus, a, um
praevaricatio |  praevaricatio, onis f
praevaricator |  praevaricator, oris m
praevaricor |  praevaricor, atus sum, ari
praevarus |  praevarus, a, um
praeveho |  praeveho, vexi, vectum, ere pass.
praevenio |  praevenio, veni, ventum, ire
praeverro |  praeverro, --, --, ere
praeverto |  praeverto (praevorto), verti (vorti), versum (vorsum), ere pass.
praevideo |  praevideo, vidi, visum, ere
praevitio |  praevitio, (avi), atum, are
praevius |  praevius, a, um
praevolo |  praevolo, avi, are
pragmaticus |  pragmaticus, a, um
Pramolanum |  Pramolan(um, i n
prandeo |  prandeo, prandi, pransum, ere
prandium |  prandium, i n
Pranonum |  Pranon(um, i n
pransus |  pransus, a, um
pratensis |  pratensis, e
pratulum |  pratulum, i n
pratum |  pratum, i n
prave |  prave adv.
pravitas |  pravitas, atis f
pravus |  pravus, a, um
Praxitenum |  Praxiten(um, i n
Praxtiteles |  Praxtiteles, is (i) m
Prazinum |  Prazin(um, i n
precarius |  precarius, a, um
precatio |  precatio, onis f
precentralis |  precentralis, e анат.
preciae |  preciae, arum f
precor |  precor, atus sum, ari
precordium |  precordium, i n
Precortalonum |  Precortalon(um, i n
Precortalum |  Precortal(um, i n
precuneus |  precuneus, i m
Predionum |  Predion(um, i n
Prednelanum |  Prednelan(um, i n
Prednisolonum |  Prednisolon(um, i n
Prednisonum |  Prednison(um, i n
Pregneninolonum |  Pregneninolon(um, i n
Pregnoralum |  Pregnoral(um, i n
prehallux |  prehallux, ucis m
prehendo |  prehendo (prendo), prehendi (prendi), prehensum (prensum), ere
prehenso |  prehenso (prenso), avi, atum, are
preinterparietalis |  preinterparietalis, e анат.
prelaryngicus |  prelaryngicus, a, um анат.
Preludinum |  Preludin(um, i n
prelum |  prelum, i n
premo |  premo, pressi, pressum, ere
premolaris |  premolaris, e анат.
prendo |  prendo, prendi, prensum, ere
Prenolonum |  Prenolon(um, i n
prensatio |  prensatio, onis f
prenso |  prenso, avi, atum, are
Prenylaminum |  Prenylamin(um, i n
preoccipitalis |  preoccipitalis, e анат.
prepatellaris |  prepatellaris, e анат.
Prephysonum |  Prephyson(um, i n
preputialis |  preputialis, e анат.
preputium |  preputium, i n
prepyloricus |  prepyloricus, a, um анат.
presacralis |  presacralis, e анат.
Presidonum |  Presidon(um, i n
Presinolum |  Presinol(um, i n
Presocylum |  Presocyl(um, i n
Presolisinum |  Presolisin(um, i n
presse |  presse adv.
Pressedinum |  Pressedin(um, i n
pressio |  pressio, onis f
presso |  presso, --, --, are
pressor |  pressor, oris m
pressus |  I pressus, a, um m
Presurenum |  Presuren(um, i n
pretectalis |  pretectalis, e анат.
pretiose |  pretiose adv.
pretiosus |  pretiosus, a, um поэт.
pretium |  pretium, i n
pretrachealis |  pretrachealis, e анат.
prevertebralis |  prevertebralis, e анат.
prex |  prex, precis f
Priamus |  Priamus, i m
Priapus |  Priapus, i m
pridem |  pridem adv.
pridie |  pridie adv.
Primachinum |  Primachin(um, i n
primaevus |  primaevus, a, um
primanus |  primanus, a, um
Primaquinum |  Primaquin(um, i n
primarius |  primarius, a, um биолог.
Primates |  Primates, um m
Primavitum |  Primavit(um, i n
primitiae |  primitiae, arum f
primitivus |  primitivus, a, um
primo |  primo adv.
Primogynum |  Primogyn(um, i n
Primonum |  Primon(um, i n
primordialis |  primordialis, e
primordium |  primordium, i n
primoris |  primoris, e
primum |  I primum adv.
primus |  primus, a, um superl.
princeps |  princeps, ipis pl.
principalis |  principalis, e
principatus |  principatus, us m
principialis |  principialis, e анат.
principium |  principium, i n
Priodaxum |  Priodax(um, i n
prior |  prior, prius compar.
prisce |  prisce adv.
priscus |  priscus, a, um поэт.
prisma |  prisma, atis n
pristinus |  pristinus, a, um
pristis |  pristis, is (поэт. pistrix, icis) f
prius |  prius adv.
priusquam |  priusquam conj.
privatim |  privatim adv.
privatio |  privatio, onis f
privatus |  privatus, a, um
privigna |  privigna, ae f
privignus |  privignus, i m
privilegium |  privilegium, i n
Privinum |  Privin(um, i n
privo |  privo, avi, atum, are
privus |  privus, a, um
prnemunitio |  prnemunitio, onis f
pro |  I pro praep.
proagorus |  proagorus, i m
proavitus |  proavitus, a, um
proavus |  proavus, i m
probabilis |  probabilis, e
probabilitas |  probabilitas, atis f
probabiliter |  probabiliter adv.
probatio |  probatio, onis, f
probator |  probator, oris m
probatus |  probatus, a, um
probe |  probe adv.
probitas |  probitas, atis f
probo |  probo, avi, atum, are
proboscis |  proboscis, idis f
probrosus |  probrosus, a, um
probrum |  probrum, i n
probus |  probus, a, um
procacitas |  procacitas, atis f
procaciter |  procaciter adv.
Procainamidum |  Procainamid(um, i n
Procainum |  Procain(um, i n
Procalmadiolum |  Procalmadiol(um, i n
Procalmum |  Procalm(um, i n
Procardilum |  Procardil(um, i n
procaryota |  procaryota, orum n
Procas |  Proca(s), ae m
procax |  procax, acis
procedo |  procedo, cessi, cessum, ere
procella |  procella, ae f
procellosus |  procellosus, a, um
procer |  procer, eris m
procere |  procere adv.
proceritas |  proceritas, atis f
procerus |  procerus, a, um анат.
processio |  processio, onis f
processus |  I processus, us m
Prochlorpemazinum |  Prochlorpemazin(um, i n
Prochlorpermazinum |  Prochlorpermazin(um, i n
Procholonum |  Procholon(um, i n
procido |  procido, cidi, --, ere
Procillinum |  Procillin(um, i n
procinctus |  procinctus, us m
proclamator |  proclamator, oris m
proclamo |  proclamo, avi, atum, are
proclino |  proclino, avi, atum, are
proclive |  proclive (proclivi) adv.
proclivis |  proclivis, e
proclivitas |  proclivitas, atis f
proclivus |  proclivus, a, um
proconsul |  proconsul, sulis m
proconsularis |  proconsularis, e
proconsulatus |  proconsulatus, us m
procor |  procor, --, ari
Procortanum |  Procortan(um, i n
procrastinatio |  procrastinatio, onis f
procrastino |  procrastino, avi, atum, are
procreatio |  procreatio, onis f
procreator |  procreator, oris m
procreatrix |  procreatrix, icis f
procreo |  procreo, avi, atum, are
Procrustes |  Procrustes, ae m
proctalgia |  proctalgia, ae f
proctectomia |  proctectomia, ae f
proctitis |  proctitis, idis f
proctologus |  proctologus, i m
proctopexia |  proctopexia, ae f
proctorrhagia |  proctorrhagia, ae f
proctospasmus |  proctospasmus, i m
proctostenosis |  proctostenosis, is f
proctostomia |  proctostomia, ae f
procubo |  procubo, --, --, are
procudo |  procudo, cudi, cusum, ere
procul |  procul adv.
proculco |  proculco, avi, atum, are
procumbo |  procumbo, cubui, cubitum, ere
Procuranum |  Procuran(um, i n
procuratio |  procuratio, onis f
procurator |  procurator, oris m
procuratrix |  procuratrix, icis f
procuro |  procuro, avi, atum, are
procurro |  procurro, cucurri (curri), cursum, ere воен.
procursatio |  procursatio, onis f
procursator |  procursator, oris m
procurso |  procurso, --, --, are
procursus |  procursus, us m
procurvus |  procurvus, a, um
procus |  procus, i m
Procytoxum |  Procytox(um, i n
prodeo |  prodeo (proeo), ii, itum, ire
Prodiabenum |  Prodiaben(um, i n
prodico |  prodico, dixi, dictum, ere
prodictator |  prodictator, oris m
prodige |  prodige adv.
prodigentia |  prodigentia, ae f
prodigialiter |  prodigialiter adv.
Prodigiosanum |  Prodigiosan(um, i n
prodigiosus |  prodigiosus, a, um
prodigium |  prodigium, i n
prodigo |  prodigo, egi, --, ere
prodigus |  prodigus, a, um поэт.
proditio |  proditio, onis f
proditor |  proditor, oris m
prodo |  prodo, didi, ditum, ere поэт.
prodoceo |  prodoceo, --, --, ere
Prodormolum |  Prodormol(um, i n
Prodormum |  Prodorm(um, i n
Prodoxum |  Prodox(um, i n
prodromus |  prodromus, i m
produco |  produco, duxi, ductum, ere
producte |  producte adv.
productio |  productio, onis f
productus |  productus, a, um
proeliator |  proeliator, oris m
proelior |  proelior, atus sum, ari
proelium |  proelium, i n
profano |  profano, avi, atum, are
profanus |  profanus, a, um поэт.
profectio |  profectio, onis f
profecto |  profecto adv.
profectus |  profectus, us m
Profecundinum |  Profecundin(um, i n
profero |  profero, tuli, latum, ferre воен.
professio |  professio, onis f
professor |  professor, oris m
professorius |  professorius, a, um
profestus |  profestus, a, um
proficio |  proficio, feci, fectum, ere
proficiscor |  proficiscor, fectus sum, ficisci
profiteor |  profiteor, fessus sum, eri
profligator |  profligator, oris m
profligatus |  profligatus, a, um
profligo |  profligo, avi, atum, are
proflo |  proflo, avi, atum, are
profluens |  I profluens, entis n
profluenter |  profluenter adv.
profluentia |  profluentia, ae f
profluo |  profluo, fluxi, fluxum, ere
profluvium |  profluvium, i n
profor |  profor, fatus sum, ari
profore |  profore inf.
profugio |  profugio, fugi, fugitum, ere
profugus |  I profugus, a, um m
profundo |  profundo, fudi, fusum, ere pass.
profundum |  profundum, i n
profundus |  profundus, a, um поэт.
profuse |  profuse adv.
profusus |  profusus, a, um мед.
Progelanum |  Progelan(um, i n
progener |  progener, eri m
progenero |  progenero, --, --, are
progenia |  progenia, ae f
progenies |  progenies, ei f
progenitor |  progenitor, oris m
Progesteroidum |  Progesteroid(um, i n
Progestinum |  Progestin(um, i n
Progestoralum |  Progestoral(um, i n
progigno |  progigno, genni, genitum, ere
prognathia |  prognathia, ae f
prognatismus |  prognatismus, i m
prognatus |  prognatus, a, um
prognosis |  prognosis, is f
prognostica |  prognostica, orum n
progrediens |  progrediens, entis мед.
progredior |  progredior, gressus sum, gredi
progressio |  progressio, onis f
progressivus |  progressivus, a, um мед.
progressus |  progressus, us m
Proguanidum |  Proguanid(um, i n
Proguanilum |  Proguanil(um, i n
Progynonum |  Progynon(um, i n
proh |  proh! interj.
prohibeo |  prohibeo, bui, bitum, ere воен.
prohibitio |  prohibitio, onis f
proin |  proin
proinde |  proinde adv.
projectio |  projectio, onis f
projectus |  projectus, a, um
projicio |  projicio, jeci, jectum, ere pass.
prolabor |  prolabor, lapsus sum, labi
Prolactinum |  Prolactin(um, i n
prolapsio |  prolapsio, onis f
prolapsus |  prolapsus, us m
prolatio |  prolatio, onis f
prolato |  prolato, avi, atum, are
prolecto |  prolecto, avi, atum, are
proles |  proles, is f
proletarius |  proletarius, i m
prolicio |  prolicio, --, --, ere
prolixe |  prolixe adv.
Prolixinum |  Prolixin(um, i n
prolixus |  prolixus, a, um
proloquor |  proloquor, cutus (quutus) sum, loqui
proludo |  proludo, lusi, --, ere
proluo |  proluo, lui, lutum, ere поэт.
prolusio |  prolusio, onis f
Prolutonum |  Proluton(um, i n
proluvies |  proluvies, ei f
Promactilum |  Promactil(um, i n
Promazinamidum |  Promazinamid(um, i n
Promazinonum |  Promazinon(um, i n
Promazinum |  Promazin(um, i n
Promedolum |  Promedol(um, i n
Promeranum |  Promeran(um, i n
promereo |  promereo, ui, itum, ere
promereor |  promereor, itus sum, eri
promeritum |  promeritum, i n
Promethazinum |  Promethazin(um, i n
Prometheus |  Prometheus (=Promethe^us), ei (eos) m
prominens |  prominens, entis
prominentia |  prominentia, ae f
promineo |  promineo, minui, --, ere
Promiodolum |  Promiodol(um, i n
promisce |  promisce (promiscue) adv.
promiscus |  promiscus, a, um
promiscuus |  promiscuus, a, um
promissio |  promissio, onis f
promissor |  promissor, oris m
promissum |  promissum, i n
promissus |  promissus, a, um поэт.
promitto |  promitto, misi, missum, ere
promo |  promo, prompsi, promptum, ere
promoneo |  promoneo, --, --, ere
promontorium |  I promontorium n
promoveo |  promoveo, movi, motum, ere воен.
prompte |  prompte adv.
promptuarium |  promptuarium, i n
promptus |  I promptus, a, um m
promulgatio |  promulgatio, onis f
promulgo |  promulgo, avi, atum, are
promulsis |  promulsis, idis f
promunturium |  promunturium, i n
promus |  promus, i m
promutuus |  promutuus, a, um
pronatio |  pronatio, onis f
pronator |  pronator, oris m
prone |  prone adv.
pronephros |  pronephros, i m
pronepos |  pronepos, otis m
proneptis |  proneptis, is f
Pronestylum |  Pronestyl(um, i n
Pronetalolum |  Pronetalol(um, i n
pronoea |  pronoea, ae f
pronominatio |  pronominatio, onis f
Prontalbinum |  Prontalbin(um, i n
Prontalinum |  Prontalin(um, i n
Prontamidum |  Prontamid(um, i n
Prontoinum |  Prontoin(um, i n
pronuba |  pronuba, ae f
pronuntiatio |  pronuntiatio, onis f
pronuntiator |  pronuntiator, oris m
pronuntiatum |  pronuntiatum, i n
pronuntio |  pronuntio, avi, atum, are юр.
pronurus |  pronurus, us f
pronus |  pronus, a, um поэт.
prooemium |  prooemium, i n
propaedeutica |  propaedeutica, ae f
propagatio |  propagatio, onis f
propagator |  propagator, oris m
propago |  I propago, avi, atum, are f
propalam |  propalam adv.
Propaminum |  Propamin(um, i n
Propanididum |  Propanidid(um, i n
Propapheninum |  Propaphenin(um, i n
propatulum |  I propatulum, i n
Propazinum |  Propazin(um, i n
prope |  I prope adv.
propediem |  propediem adv.
propello |  propello, puli, pulsum, ere
propemodum |  propemodum adv.
propendeo |  propendeo, pendi, pensum, ere
propense |  propense adv.
propensio |  propensio, onis f
propensus |  propensus, a, um
properanter |  properanter adv.
properantia |  properantia, ae f
properatio |  properatio, onis f
properato |  properato adv.
propere |  propere adv.
Propericiazinum |  Propericiazin(um, i n
propero |  propero, avi, atum, are
Propertius |  Propertius, i m
properus |  properus, a, um
propexus |  propexus, a, um
prophasis |  prophasis, is f
propino |  propino, avi, atum, are
propinquitas |  propinquitas, atis f
propinquo |  propinquo, avi, atum, are
propinquus |  propinquus, a, um
propior |  propior, ius compar.
propitio |  propitio, avi, atum, are
propitius |  propitius, a, um
propius |  propius adv.
propolluo |  propolluo, --, --, ere
propoma |  propoma, ae f
propono |  propono, posui, positum, ere pass.
Propontis |  Propontis, idis (idos) f
proportio |  proportio, onis f
propositio |  propositio, onis f
propositum |  propositum, i n
propositus |  propositus, a, um
propraetor |  propraetor, oris m
proprie |  proprie adv.
proprietas |  proprietas, atis f
proprius |  proprius, a, um
propter |  I propter adv.
propterea |  propterea adv.
propudium |  propudium, i n
propugnaculum |  propugnaculum, i n
propugnatio |  propugnatio, onis f
propugnator |  propugnator, oris m
propugno |  propugno, avi, atum, are
propulsatio |  propulsatio, onis f
propulso |  propulso, avi, atum, are
propylaea |  propylaea, orum n
Propyliodonum |  Propyliodon(um, i n
Propylixum |  Propylix(um, i n
Propylsympatolum |  Propylsympatol(um, i n
proquaestore |  proquaestore (= pro quaestore) m
prora |  prora, ae f
prorepo |  prorepo, repsi, reptum, ere
proripio |  proripio, ripui, reptum, ere
prorogatio |  prorogatio, onis f
prorogo |  prorogo, avi, atum, are
prorsus |  prorsus ( арх.
prorumpo |  prorumpo, rupi, ruptum, ere pass.
proruo |  proruo, rui, rutum, ere
prosa |  prosa, ae f
prosapia |  prosapia, ae f
proscenium |  proscenium, i n
proscindo |  proscindo, scidi, scissum, ere
proscribo |  proscribo, scripsi, scriptum, ere
proscriptio |  proscriptio, onis f
proscripturio |  proscripturio, --, --, ire
proseco |  proseco, secui, sectum, are
prosecta |  prosecta, orum n
prosemino |  prosemino, avi, atum, are
prosencephalon |  prosencephalon, i n
Proseptinum |  Proseptin(um, i n
prosequor |  prosequor, cutus (quutus) sum, sequi
Proserinum |  Proserin(um, i n
Proserpina |  Proserpina, ae f
prosilio |  prosilio, ui (ivi, ii), --, ire
prosocer |  prosocer, eri m
prospecto |  prospecto, avi, atum, are
prospectus |  prospectus, us m
prospeculor |  prospeculor, --, atum, ari
prosper |  prosper, era, erum
prospera |  prospera, orum n
prospere |  prospere adv.
prosperitas |  prosperitas, atis f
prospero |  prospero, avi, atum, are
prosperus |  prosperus, a, um поэт.
prospicientia |  prospicientia, ae f
prospicio |  prospicio, spexi, spectum, ere
Prospidinum |  Prospidin(um, i n
Prostaphlinum |  Prostaphlin(um, i n
prostata |  prostata, ae f
prostaticus |  prostaticus, a, um анат.
prosterno |  prosterno, stravi, stratum, ere
prostituo |  prostituo, stitui, stitutum, ere
prosto |  prosto, stiti, --, are
prostoma |  prostoma, atis n
Prostrumilum |  Prostrumil(um, i n
prosubigo |  prosubigo, --, --, ere
prosum |  prosum, profui, --, prodesse
prosus |  I prosus
Protandrenum |  Protandren(um, i n
Protargolum |  Protargol(um, i n
protego |  protego, texi, tectum, ere
protendo |  protendo, tendi, tensum (tentum), ere
protenus |  protenus (protinus) adv.
protero |  protero, trivi, tritum, ere поэт.
proterreo |  proterreo, terrui, territum, ere
proterve |  proterve adv.
protervitas |  protervitas, atis f
protervus |  protervus, a, um
Proteus |  Proteus (=Prote^us), ei (eos) m
prothrombinum |  prothrombinum, i n
protinus |  protinus adv.
Protobranchia |  I Protobranchia, orum n
protoplasma |  protoplasma, atis n
Protozoa |  Protozoa, orum n
protraho |  protraho, traxi, tractum, ere
protrudo |  protrudo, trusi, trusum, ere
protuberantia |  protuberantia, ae f
proturbo |  proturbo, avi, atum, are ����.
prout |  prout conj.
provectus |  provectus, a, um
proveho |  proveho, vexi, vectum, ere pass.
provenio |  provenio, veni, ventum, ire
proventus |  proventus, us m
proverbium |  proverbium, i n
providens |  providens, entis
providenter |  providenter adv.
providentia |  providentia, ae f
provideo |  provideo, vidi, visum, ere
providus |  providus, a, um
provincia |  provincia, ae f
provincialis |  provincialis, e
provisio |  provisio, onis f
provisor |  provisor, oris m
provisus |  provisus, us m
provivo |  provivo, --, --, ere
provocatio |  provocatio, onis f
provocator |  provocator, oris m
provoco |  provoco, avi, atum, are
provolo |  provolo, avi, atum, are
provolvo |  provolvo, volvi, volutum, ere pass.
proximalis |  proximalis, e анат.
proxime |  proxime adv.
proximitas |  proximitas, atis f
proximo |  proximo adv.
proximum |  proximum, i n
proximus |  proximus, a, um superl.
proxumus |  proxumus, a, um
prudens |  prudens, entis
prudenter |  prudenter adv.
prudentia |  prudentia, ae f
pruina |  pruina, ae поэт.
pruinosus |  pruinosus, a, um
pruna |  pruna, ae f
pruniceus |  pruniceus, a, um
prunum |  prunum, i n
prunus |  prunus, i f
prupola |  prupola, ae m
prytaneum |  prytaneum, i n
prytanis |  prytanis, is ( acc.
psallo |  psallo, psalli, --, ere
psalterium |  psalterium, i n
psaltria |  psaltria, ae f
psephisma |  psephisma, atis n
pseudobacca |  pseudobacca, ae f
pseudogamia |  pseudogamia, ae f
pseudomenos |  pseudomenos, i m
pseudopodium |  pseudopodium, i n
pseudothyrum |  pseudothyrum, i n
psithius |  psithius (psythius), a, um
psittacus |  psittacus, i m
psoa |  psoa, as f
psoas |  psoas (musculus)
psychasthenia |  psychasthenia, ae f
Psyche |  Psyche, es f
psychiater |  psychiater, tri m
psychiatria |  psychiatria, ae f
psychogenus |  psychogenus, a, um
psychologus |  psychologus, i m
psychomantium |  psychomantium, i n
psychosis |  psychosis, is f
psychotherapia |  psychotherapia, ae f
psythius |  psythius, a, um
pterocarpus |  pterocarpus, a, um
pterodactylus |  pterodactylus, i m
pterygoideus |  pterygoideus, а, um
pterygoma |  pterygoma, atis n
pterygomandibularis |  pterygomandibularis, e анат.
pterygomaxillaris |  pterygomaxillaris, e анат.
pterygopalatinus |  pterygopalatinus, a, um анат.
pterygopharyngeus |  pterygopharyngeus, a, um анат.
pterygospinalis |  pterygospinalis, e анат.
pterygospinosus |  pterygospinosus, a, um анат.
pterynon |  pterynon, i n
pteryx |  pteryx, ygos f
ptisanarium |  ptisanarium, i n
ptosis |  ptosis, is f
pubens |  pubens, entis
puber |  puber, eris
pubertas |  pubertas, atis f
pubes |  I pubes, eris поэт.
pubesco |  pubesco, bui, --, ere
pubicus |  pubicus, a, um анат.
publicanus |  I publicanus, a, um m
publicatio |  publicatio, onis f
publice |  publice adv.
publico |  publico, avi, atum, are
publicum |  publicum, i n
publicus |  publicus, a, um преим.
pubofemoralis |  pubofemoralis, e анат.
puboprostaticus |  puboprostaticus, a, um анат.
puborectalis |  puborectalis, e анат.
pubovesicalis |  pubovesicalis, e анат.
Puccinia |  Puccinia, ae f
pudendalis |  pudendalis, e анат.
pudendum |  pudendum, i n
pudendus |  pudendus, a, um биолог.
pudens |  pudens, entis
pudenter |  pudenter adv.
pudeo |  pudeo, ui, itum, ere impers.
pudibundus |  pudibundus, a, um
pudicitia |  pudicitia, ae f
pudicus |  pudicus, a, um
pudor |  pudor, oris m
puella |  puella, ae f
puellaris |  puellaris, e
puer |  puer, eri m
puerilis |  puerilis, e
pueriliter |  pueriliter adv.
pueritia |  pueritia, ae f
puerpera |  puerpera, ae f
puerperium |  puerperium, i n
puertia |  puertia
puerulus |  puerulus, i m
puga |  puga
pugatim |  pugatim adv.
pugil |  pugil, ilis m
pugilatus |  pugilatus, us m
pugio |  pugio, onis m
pugiunculus |  pugiunculus, i m
pugna |  pugna, ae f
pugnaciter |  pugnaciter adv.
pugnator |  pugnator, oris m
pugnax |  pugnax, acis
pugno |  pugno, avi, atum, are
pugnus |  pugnus, i m
pulcer |  pulcer, cra, crum
pulchellus |  pulchellus, a, um
pulcher |  pulcher, chra, chrum
pulchre |  pulchre (pulcre) adv.
pulchritudo |  pulchritudo, inis f
pulcre |  pulcre adv.
pulejum |  pulejum, i n
pulex |  pulex, icis m
pullarius |  pullarius, i m
pullulo |  pullulo, --, --, are
pullum |  pullum, i n
pullus |  I pullus, a, um m
pulmentarium |  pulmentarium, i n
pulmentum |  pulmentum, i n
pulmo |  pulmo, onis m
pulmonalis |  pulmonalis, e анат.
Pulmonaria |  Pulmonaria, ae f
pulmonectasia |  pulmonectasia, ae f
pulpa |  pulpa, ae f
pulpamen |  pulpamen, inis n
pulpamentum |  pulpamentum, i n
pulpitum |  pulpitum, i n
pulposus |  pulposus, a, um анат.
puls |  puls, pultis f
pulsatio |  pulsatio, onis f
pulso |  pulso, avi, atum, are поэт.
pulsus |  pulsus, us m
pulvereus |  pulvereus, a, um
pulverulentus |  pulverulentus, a, um
pulvillus |  pulvillus, i m
pulvinar |  pulvinar, aris n
pulvinarium |  pulvinarium, i n
pulvinus |  pulvinus, i m
pulvis |  pulvis, eris m
pumex |  pumex, icis m
pumiceus |  pumiceus, a, um
pumilio |  pumilio, onis m
punctim |  punctim adv.
punctum |  punctum, i n
pungo |  pungo, pupugi, punctum, ere
punio |  punio (poenio), ivi (ii), itum, ire
punior |  punior (poenior), itus sum, iri
punitor |  punitor (poenitor), oris m
pupilla |  I pupilla, ae f
pupillaris |  I pupillaris, e анат.
pupillus |  pupillus, i m
puppis |  puppis, is f
pupula |  pupula, ae f
pure |  pure adv.
purgamen |  purgamen, inis n
purgamentum |  purgamentum, i n
purgatio |  purgatio, onis f
purgo |  purgo, avi, atum, are поэт.
puriter |  puriter
purpaco |  purpaco, avi, atum, are
purpura |  purpura, ae f
purpurasco |  purpurasco, --, --, ere
purpuratus |  purpuratus, a, um pl.
purpureus |  purpureus, a, um поэт.
purulentus |  purulentus, a, um мед.
purus |  purus, a, um юр.
pus |  pus, puris n
pusillus |  pusillus, a, um
pusio |  pusio, onis m
pustula |  pustula, ae f
puta |  puta adv.
putamen |  putamen, inis n
putatio |  putatio, onis f
puteal |  puteal, alis n
putealis |  putealis, e
putearius |  putearius, i m
puteo |  puteo, ui, --, ere
puter |  puter, tris, tre
putesco |  putesco (putisco), tui, --, ere
puteus |  puteus, i m
putide |  putide adv.
putidiusculus |  putidiusculus, a, um
putidus |  putidus, a, um
putisco |  putisco
puto |  I puto, avi, atum, are
putrefacio |  putrefacio, feci, factum, ere
putrefio |  putrefio, factus sum, fieri pass.
putresco |  putresco, trui, --, ere
putridus |  putridus, a, um
putris |  putris, e
putus |  I putus, a, um m
Pydna |  Pydna, ae f
pyelectasia |  pyelectasia, ae f
pyelitis |  pyelitis, idis f
pyelonephritis |  pyelonephritis, idis f
pyelotomia |  pyelotomia, ae f
pyga |  pyga, ae f
Pygmaei |  Pygmaei, orum m
Pygmalion |  Pygmalion, onis m
pylae |  pylae, arum f
pyloricus |  pyloricus, a, um анат.
pylorospasmus |  pylorospasmus, i m
pylorostenosis |  pylorostenosis, is f
pylorus |  pylorus, i m
Pylos |  Pylos (-us), i f
pyodermia |  pyodermia, ae f
pyogenus |  pyogenus, a, um мед.
pyometra |  pyometra, ae f
pyosalpinx |  pyosalpinx, ingis f
pyothorax |  pyothorax, acis m
pyra |  pyra, ae f
pyramidalis |  pyramidalis, e анат.
pyramis |  pyramis, idis f
Pyramus |  Pyramus, i m
Pyrenaeus |  Pyrenaeus, i m
pyrethron |  pyrethron (pyretron, pyrethrum, pyretrum) i n
Pyrra |  Pyrra (Pyrrha), ae f
Pyrrho |  Pyrrho, onis m
Pyrrhus |  Pyrrhus (Pyrrus), i m
Pythagoras |  Pythagoras, ae m
Pythagorici |  Pythagorici, orum m
Pythia |  I Pythia, ae f
Python |  Python, onis m
pyuria |  pyuria, ae f
pyxis |  pyxis, idis f
