rabbinus |  rabbinus, i m
rabide |  rabide adv.
rabidus |  rabidus, а, um
rabies |  rabies, ei f
rabiose |  rabiose adv.
rabiosulus |  rabiosulus, a, um
rabiosus |  rabiosus, a, um
rabula |  rabula, ae m
Racemelphalanum |  Racemelphalan(um, i n
racemifer |  racemifer, era, erum бот.
racemosus |  racemosus, a, um анат.
racemus |  racemus, i m
Racephenum |  Racephen(um, i n
Radedormum |  Radedorm(um, i n
Radepurum |  Radepur(um, i n
radialis |  radialis, e анат.
radiatio |  radiatio, onis f
radiatus |  radiatus, a, um анат.
radicitus |  radicitus adv.
radicula |  radicula, ae f
radicularis |  radicularis, e анат.
radio |  radio, avi, atum, are
radiocarpeus |  radiocarpeus, a, um анат.
radiophonia |  radiophonia, ae f
radior |  radior, radiatus sum, ari
Radioselectanum |  Radioselectan(um, i n
radiostantio |  radiostantio, onis f
radioulnaris |  radioulnaris, e анат.
radius |  radius, i m
radix |  radix, icis f
rado |  rado, rasi, rasum, ere поэт.
radula |  radula, ae f
Raeti |  Raeti, orum m
Raetia |  Raetia, ae f
ramale |  ramale, is n
ramentum |  ramentum, i n
rameus |  rameus, a, um
ramicola |  ramicola, ae m
ramiculus |  ramiculus, i m
Ramnicapra |  Ramnicapra, ae f
ramosus |  ramosus, a, um
ramulus |  ramulus, i m
ramus |  ramus, i m
rana |  rana, ae f
rancidus |  rancidus, a, um
raninus |  raninus, a, um
ranunculus |  ranunculus, i m
rapacitas |  rapacitas, atis f
rapax |  rapax, acis
Raphanus |  Raphanus, i m
raphe |  raphe, es f
rapide |  rapide adv.
rapiditas |  rapiditas, atis f
rapidus |  rapidus, a, um поэт.
rapina |  rapina, ae f
rapio |  rapio, rapui, raptum, ere, поэт.
raptim |  raptim adv.
rapto |  rapto, avi, atum, are
raptor |  raptor, oris m
raptus |  raptus, us m
rapulum |  rapulum, i n
rapum |  rapum, i n
raresco |  raresco, --, --, ere,
raritas |  raritas, atis f
raro |  raro adv.
rarus |  rarus, a, um поэт.
rasilis |  rasilis, e
raster |  raster, tri m
Rastinonum |  Rastinon(um, i n
ratio |  ratio, onis f
ratiocinatio |  ratiocinatio, onis f
ratiocinativus |  ratiocinativus, a, um
ratiocinator |  ratiocinator, oris m
ratiocinor |  ratiocinor, atus sum, ari
ratis |  ratis, is f
ratiuncula |  ratiuncula, ae f
ratus |  ratus, a, um поэт.
raucus |  raucus, a, um поэт.
Raudiazinum |  Raudiazin(um, i n
Raudixinum |  Raudixin(um, i n
raudus |  raudus (rudus), eris n
raudusculum |  raudusculum, i n
Raunatinum |  Raunatin(um, i n
Raupasilum |  Raupasil(um, i n
Raupina |  Raupina, ae f
Rauraci |  Rauraci, orum m
Rausedanum |  Rausedan(um, i n
Rausedylum |  Rausedyl(um, i n
Rauwasanum |  Rauwasan(um, i n
Rauwolfia |  Rauwolfia, ae f
Ravenalum |  Ravenal(um, i n
Ravenna |  Ravenna, ae f
ravus |  ravus, a, um
rea |  I rea, ae f
reapse |  reapse adv.
Reate |  Reate, is n
Reazidum |  Reazid(um, i n
rebellatio |  rebellatio, onis f
rebellatrix |  rebellatrix, icis f
rebelles |  rebelles, ium m
rebellio |  rebellio, onis f
rebellis |  rebellis, e
rebello |  rebello, avi, atum, are поэт.
reboo |  reboo, --, --, are
recalcitro |  recalcitro, --, --, are
recalefacio |  recalefacio
recaleo |  recaleo, --, --, ere
recalesco |  recalesco, lui, --, ere
recalfacio |  recalfacio (recalefacio), feci, factum, ere
recandesco |  recandesco, candui, --, ere
recanto |  recanto, --, --, are
recedo |  recedo, cessi, cessum, ere
recello |  recello, --, --, ere
recens |  recens, entis
recenseo |  recenseo, censui, censitum (censum), ere
recensio |  recensio, onis f
recensus |  recensus, us m
receptaculum |  I receptaculum, i n
recepto |  recepto, avi, atum, are поэт.
receptor |  receptor, oris m
receptrix |  receptrix, icis f
receptum |  receptum, i n
receptus |  receptus, us m
recessus |  recessus, us m
recidivus |  recidivus, a, um поэт.
recido |  I recido, cidi, casum, ere
recingo |  recingo, cinxi, cinctum, ere pass.
recinium |  recinium
recino |  recino, --, --, ere
reciper |  reciper...
recipio |  recipio, cepi, ceptum, ere воен.
reciproco |  reciproco, avi, atum, are
reciprocus |  reciprocus, a, um
recitatio |  recitatio, onis f
recitator |  recitator, oris m
recito |  recito, avi, atum, are
reclamatio |  reclamatio, onis f
reclamito |  reclamito, --, --, are
reclamo |  reclamo, avi, atum, are поэт.
reclinis |  reclinis, e
reclino |  reclino, avi, atum, are поэт.
recludo |  recludo, clusi, clusum, ere поэт.
recogito |  recogito, avi, --, are
recognitio |  recognitio, onis f
recognosco |  recognosco, cognovi, cognitum, ere
recolligo |  recolligo, legi, lectum, ere
recolo |  recolo, colui, cultum, ere
recompono |  recompono, (posui), positum, ere
reconciliatio |  reconciliatio, onis f
reconcilio |  reconcilio, avi, atum, are
reconcillator |  reconcillator, oris m
reconcinno |  reconcinno, --, --, are
reconditus |  reconditus, a, um
recondo |  recondo, didi, ditum, ere поэт.
recoquo |  recoquo, coxi, coctum, ere
recordatio |  recordatio, onis f
recordor |  recordor, atus sum, ari
recreo |  recreo, avi, atum, are pass.
recrepo |  recrepo, --, --, are
recresco |  recresco, crevi, --, ere
recrudesco |  recrudesco, dui, --, ere
recta |  recta adv.
rectalis |  rectalis, e анат.
recte |  recte adv.
rectificatus |  rectificatus, a, um хим.
rectio |  rectio, onis f
rectococcygeus |  rectococcygeus, a, um анат.
rector |  rector, oris m
rectoscopia |  rectoscopia, ae f
rectourethralis |  rectourethralis, e анат.
rectouterinus |  rectouterinus, a, um анат.
rectovaginalis |  rectovaginalis, e анат.
rectovesicalis |  rectovesicalis, e анат.
rectum |  rectum, i n
rectus |  rectus, a, um
recubo |  recubo, --, --, are
recumbo |  recumbo, cubui, --, ere
recuperatio |  recuperatio (reciperatio), onis f
recuperator |  recuperator (reciperator), oris m
recuperatorius |  recuperatorius (reciperatorius), a, um
recupero |  recupero (recipero), avi, atum, are
recurrens |  recurrens, entis
recurro |  recurro, curri, cursum, ere
recurso |  recurso, --, --, are
recursus |  recursus, us m
recurvo |  recurvo, (avi), atum, are
recurvus |  recurvus, a, um
recusatio |  recusatio, onis f
recuso |  recuso, avi, atum, are юр.
recutio |  recutio, --, cussus, ere
reda |  reda (raeda), ae f
Redaminum |  Redamin(um, i n
redamo |  redamo, --, --, are
redardesco |  redardesco, --, --, ere
redarguo |  redarguo, ui, utum, ere
redarius |  redarius, i m
reddo |  reddo, didi, ditum, ere юр.
redemptio |  redemptio, onis f
redempto |  redempto, --, --, are
redemptor |  redemptor, oris m
redemptura |  redemptura, ae f
redeo |  redeo, ii (ivi), itum, ire
Redergamum |  Redergam(um, i n
redhibeo |  redhibeo, bui, bitum, ere
redigo |  redigo, egi, actum, ere
redimiculum |  redimiculum, i n
Redimilum |  Redimil(um, i n
redimio |  redimio, ii, itum, ire
redimo |  redimo, emi, emptum (emtum), ere
redintegratio |  redintegratio, onis f
redintegro |  redintegro, avi, atum, are
reditio |  reditio, onis f
reditus |  reditus, us m
redivivum |  redivivum, i n
redivivus |  redivivus, a, um
redoleo |  redoleo, ui, --, ere
Redomexum |  Redomex(um, i n
redomitus |  redomitus, a, um
redono |  redono, avi, --, are
Redoxonum |  Redoxon(um, i n
reduco |  reduco, duxi, ductum, ere воен.
reductio |  reductio, onis f
reductor |  reductor, oris m
reductus |  reductus, a, um хим.
reduncus |  reduncus, a, um
redundantia |  redundantia, ae f
redundo |  redundo, avi, atum, are
reduvia |  reduvia, ae f
redux |  redux, ucis
refello |  refello, felli, --, ere
refercio |  refercio, fersi, fertum, ire
referio |  referio, --, ire
refero |  refero, tuli, latum, ferre pass.
refert |  refert, retulit, --, referre impers.
refertus |  refertus, a, um
referveo |  referveo, --, --, ere
refervesco |  refervesco, --, --, ere
reficio |  reficio, feci, fectum, ere
refigo |  refigo, fixi, fixum, ere
refingo |  refingo, --, --, ere
reflatus |  reflatus, us m
reflecto |  reflecto, flexi, flexum, ere pass.
reflexus |  reflexus, us m
reflo |  reflo, avi, atum, are
refluo |  refluo, fluxi, --, ere
refluus |  refluus, a, um
Refobacinum |  Refobacin(um, i n
reformidatio |  reformidatio, onis f
reformido |  reformido, avi, atum, are
reformo |  reformo, avi, atum, are
refoveo |  refoveo, fovi, fotum, ere
refractariolus |  refractariolus, a, um
refraeno |  refraeno
refragor |  refragor, atus sum, ari
refreno |  refreno, avi, atum, are
refrico |  refrico, fricui, fricatum, are
refrigero |  refrigero, avi, atum, are pass.
refrigesco |  refrigesco, frixi, --, ere
refringo |  refringo, fregi, fractum, ere
refugio |  refugio, fugi, fugitum, ere
refugium |  refugium, i n
refugus |  refugus, a, um поэт.
refulgeo |  refulgeo, fulsi, --, ere
refundo |  refundo, fudi, fusum, ere поэт.
Refusalum |  Refusal(um, i n
refutatio |  refutatio, onis f
refuto |  refuto, avi, atum, are
regalis |  regalis, e
regaliter |  regaliter adv.
Regelanum |  Regelan(um, i n
regemo |  regemo, --, --, ere
regenerator |  regenerator, oris m
Regenonum |  Regenon(um, i n
regero |  regero, gessi, gestum, ere
regia |  regia, ae f
regie |  regie adv.
regificus |  regificus, a, um
regii |  regii, orum m
regimen |  regimen, inis n
regina |  regina, ae f
regio |  regio, onis f
regionatim |  regionatim adv.
Regitinum |  Regitin(um, i n
Regium |  Regium, i n
regius |  regius, a, um
regnator |  regnator, oris m
regnatrix |  regnatrix, icis f
regno |  regno, avi, atum, are
regnum |  regnum, i n
rego |  rego, rexi, rectum, ere
regredior |  regredior, gressus sum, gredi
regressus |  regressus, us m
regula |  regula, ae f
regulus |  I regulus, i m
regusto |  regusto, avi, atum, are
reicio |  reicio
reinfectio |  reinfectio, onis f
rejectanea |  rejectanea, orum n
rejectaneus |  rejectaneus, a, um
rejectio |  rejectio, onis f
rejectus |  rejectus, a, um
rejiciendus |  rejiciendus, a, um
rejicio |  rejicio (reicio), jeci, jectum, ere воен.
relabor |  relabor, lapsus sum, labi поэт.
Reladormum |  Reladorm(um, i n
relanguesco |  relanguesco, langui, --, ere
Relanium |  Relanium, i n
relatio |  relatio, onis f
relator |  relator, oris m
relatus |  relatus, us m
relaxatio |  relaxatio, onis f
relaxo |  relaxo, avi, atum, are pass.
Relaxylum |  Relaxyl(um, i n
relegatio |  relegatio, onis f
relego |  I relego, avi, atum, are
relentesco |  relentesco, --, --, ere
relevo |  relevo, avi, atum, are pass.
relictio |  relictio, onis f
relictum |  relictum, i n
relicuus |  relicuus, а, um
religatio |  religatio, onis f
religio |  religio, onis f
religiose |  religiose adv.
religiosus |  religiosus, a, um
religo |  religo, avi, atum, are поэт.
relino |  relino, levi, litum, ere
relinquo |  relinquo, liqui, lictum, ere
reliqua |  reliqua, orum n
reliquiae |  reliquiae, arum f
reliquus |  reliquus, a, um
rellig |  rellig...
reluceo |  reluceo, luxi, --, ere
relucesco |  relucesco, luxi, --, ere
reluctor |  reluctor, atus sum, ari
remaneo |  remaneo, mansi, mansum, ere
remansio |  remansio, onis f
remedium |  remedium, i n
remeo |  remeo, avi, atum, are
remetior |  remetior, mensus sum, iri
remex |  remex, igis m
Remi |  Remi, orum m
remigatio |  remigatio, onis f
remigium |  remigium, i n
remigo |  remigo, avi, atum, are
remigro |  remigro, avi, atum, are
reminiscor |  reminiscor, --, minisci
remisceo |  remisceo, miscui, mistum (mixtum), ere
remisse |  remisse adv.
remissio |  remissio, onis f
remissus |  remissus, a, um
remitto |  remitto, misi, missum, ere pass.
remolior |  remolior, itus sum, iri
remollesco |  remollesco, --, --, ere
remollio |  remollio, ivi, itum, ire
remoramen |  remoramen, inis n
remordeo |  remordeo, mordi, morsum, ere
remoror |  remoror, atus sum, ari
remote |  remote adv.
remotio |  remotio, onis f
remotus |  remotus, a, um
removeo |  removeo, movi, motum, ere
remugio |  remugio, --, --, ire поэт.
remulceo |  remulceo, --, --, ere
remulcum |  remulcum, i n
Remulus |  Remulus, i m
remuneratio |  remuneratio, onis f
remunero |  remunero, --, --, are
remuneror |  remuneror, atus sum, ari
remurmuro |  remurmuro, --, --, are
remus |  I remus, i m
Remyolanum |  Remyolan(um, i n
ren |  ren, renis m
renalis |  renalis, e анат.
Renamidum |  Renamid(um, i n
renarro |  renarro, --, --, are
renascor |  renascor, natus sum, nasci
renavigo |  renavigo, --, --, are
rencularis |  rencularis, e анат.
reneo |  reneo, --, --, ere
renideo |  renideo, --, --, ere поэт.
reniformis |  reniformis, e анат.
renitor |  renitor, nisus (nixus) sum, niti
reno |  I reno (rheno), onis m
renodo |  renodo, --, --, are
Renografinum |  Renografin(um, i n
renographia |  renographia, ae f
Renostypticinum |  Renostypticin(um, i n
renovamen |  renovamen, inis n
renovatio |  renovatio, onis f
renovo |  renovo, avi, atum, are
renuntiatio |  renuntiatio, onis f
renuntio |  renuntio, avi, atum, are
renuo |  renuo, ui, --, ere
Reocorinum |  Reocorin(um, i n
reor |  reor, ratus sum, eri
repagula |  repagula, orum n
repagulum |  repagulum, i n
repandus |  repandus, a, um
reparabilis |  reparabilis, e
reparo |  reparo, avi, atum, are поэт.
repastinatio |  repastinatio, onis f
repastino |  repastino, avi, atum, are
repecto |  repecto, --, pexum, ere
repello |  repello, puli, pulsum, ere
rependo |  rependo, pendi, pensum, ere поэт.
repens |  repens, entis биолог.
repente |  repente adv.
repentino |  repentino adv.
repentinus |  repentinus, a, um
repercutio |  repercutio, cussi, cussum, ere pass.
reperio |  reperio, peri, pertum, ire
repertor |  repertor, oris m
repetitio |  repetitio, onis f
repetitor |  repetitor, oris m
repeto |  repeto, ivi (ii), itum, ere
repleo |  repleo, plevi, pletum, ere
repletus |  repletus, a, um
replicatio |  replicatio, onis f
replico |  replico, avi, atum, are
repo |  repo, repsi, reptum, ere
repono |  repono, posui, positum, ere поэт.
reporto |  reporto, avi, atum, are
reposco |  reposco, --, --, ere
repositus |  repositus (repostus), a, um
repostor |  repostor, oris m
repostus |  repostus, a, um
repotia |  repotia, orum n
repraesentatio |  repraesentatio, onis f
repraesento |  repraesento, avi, atum, are
reprehendo |  reprehendo (reprendo), prehendi (prendi), prehensum (prensum), ere
reprehensio |  reprehensio, onis f
reprehenso |  reprehenso, --, --, are
reprehensor |  reprehensor, oris m
reprendo |  reprendo
repressor |  repressor, oris m
reprimo |  reprimo, pressi, pressum, ere
reproductio |  reproductio, onis f
repromissio |  repromissio, onis f
repromitto |  repromitto, misi, missum, ere
repto |  repto, avi, atum, are
repudiatio |  repudiatio, onis f
repudio |  repudio, avi, atum, are
repudium |  repudium, i n
repuerasco |  repuerasco, --, --, ere
repugnanter |  repugnanter adv.
repugno |  repugno, avi, atum, are
repuguantia |  repuguantia, ae f
repulsa |  repulsa, ae f
repulsus |  repulsus, us m
repungo |  repungo, --, --, ere
repurgo |  repurgo, avi, atum, are поэт.
reputatio |  reputatio, onis f
reputo |  reputo, avi, atum, are
requies |  requies, etis f
requiesco |  requiesco, quievi, quietum, ere поэт.
requietus |  requietus, a, um
requiro |  requiro, quisivi, quisitum, ere
res |  res, rei f
resacro |  resacro, --, --, are
resaevio |  resaevio, --, --, ire
resaluto |  resaluto, avi, atum, are
resanesco |  resanesco, sanui, --, ere
resarcio |  resarcio, sarsi, sartum, ire
rescindo |  rescindo, scidi, scissum, ere
rescisco |  rescisco, scivi (scii), scitum, ere
rescribo |  rescribo, scripsi, scriptum, ere
reseco |  reseco, secui, sectum, are
resectio |  resectio, onis f
resemino |  resemino, --, --, are
resequor |  resequor, secutus (sequutus) sum, sequi
resero |  resero, avi, atum, are
Reserpinum |  Reserpin(um, i n
Reserpoidum |  Reserpoid(um, i n
reservo |  reservo, avi, atum, are
reses |  reses, idis
resideo |  resideo, sedi, sessum, ere
resido |  resido, sedi, sessum, ere
residuum |  residuum, i n
residuus |  residuus, a, um
resigno |  resigno, avi, atum, are поэт.
resilio |  resilio, silui, sultum, ire
resimus |  resimus, a, um
resina |  resina, ae f
resipio |  resipio, --, --, ere
resipisco |  resipisco, sipui (sipii), sipivi, ere
resisto |  resisto, stiti, stitum, ere
Resistomycinum |  Resistomycin(um, i n
Resistopenum |  Resistopen(um, i n
Resochenum |  Resochen(um, i n
Resochinum |  Resochin(um, i n
resolvo |  resolvo, solvi, solutum, ere поэт.
resonabilis |  resonabilis, e
resono |  resono, avi, --, are
resonus |  resonus, a, um
resorbeo |  resorbeo, --, --, ere
Resorcinolum |  Resorcinol(um, i n
Resorcinum |  Resorcin(um, i n
respecto |  respecto, avi, atum, are
respectus |  respectus, us m
respergo |  respergo, spersi, spersum, ere
respersio |  respersio, onis f
respicio |  respicio, spexi, spectum, ere
respiramen |  respiramen, inis n
respiratio |  respiratio, onis f
respiratorius |  respiratorius, a, um анат.
respiratus |  respiratus, us m
respiro |  respiro, avi, atum, are
resplendeo |  resplendeo, --, --, ere
respondeo |  respondeo, spondi, sponsum, ere
responsio |  responsio, onis f
responsito |  responsito, avi, --, are
responso |  responso, --, --, are поэт.
responsum |  responsum, i n
respublica |  respublica см.
respuo |  respuo, spui, --, ere
restagno |  restagno, --, --, are
Restaminum |  Restamin(um, i n
restauro |  restauro, avi, atum, are
Restenilum |  Restenil(um, i n
resticula |  resticula, ae f
restinctio |  restinctio, onis f
restinguo |  restinguo, stinxi, stinctum, ere
restipulatio |  restipulatio, onis f
restipulor |  restipulor, --, ari
restis |  restis, is f
restito |  restito, --, --, are
restituo |  restituo, ui, utum, ere
restitutio |  restitutio, onis f
restitutor |  restitutor, oris m
resto |  resto, stiti, --, are
restricte |  restricte adv.
restrictus |  restrictus, a, um
restringo |  restringo, strinxi, strictum, ere
Resulfonum |  Resulfon(um, i n
resulto |  resulto, --, --, are
resumo |  resumo, sumpsi, sumptum, ere
resupino |  resupino, avi, atum, are
resupinus |  resupinus, a, um
resurgo |  resurgo, surrexi, sarrectum, ere поэт.
resuscito |  resuscito, --, atum, are
Retabolilum |  Retabolil(um, i n
Retandrolum |  Retandrol(um, i n
retardatio |  retardatio, onis f
retardo |  retardo, avi, atum, are
Retasulfinum |  Retasulfin(um, i n
rete |  rete, is n
retego |  retego, texi, tectum, ere поэт.
retempto |  retempto, --, --, are
retendo |  retendo, tendi, tensum (tentum), ere
retentio |  retentio, onis f
retento |  I retento, avi, atum, are поэт.
retexo |  retexo, texui, textum, ere поэт.
retiarius |  retiarius, i m
reticentia |  reticentia, ae f
reticeo |  reticeo, cui, --, ere
reticularis |  reticularis, e анат.
reticulospinalis |  reticulospinalis, e анат.
reticulum |  reticulum, i n
reticulus |  reticulus, i m
retina |  retina, ae f
retinaculum |  I retinaculum, i n
retinens |  retinens, entis
retineo |  retineo, tinui, tentum, ere
Retinolum |  Retinol(um, i n
retorqueo |  retorqueo, torsi, tortum, ere
retorridus |  retorridus, a, um
retractatio |  retractatio, onis f
retractatus |  retractatus, a, um
retracto |  retracto, avi, atum, are
retractus |  retractus, a, um
retraho |  retraho, traxi, tractum, ere
retrecto |  retrecto
retribuo |  retribuo, tribui, tributum, ere
retro |  retro adv.
retroauricularis |  retroauricularis, e анат.
retrobuccalis |  retrobuccalis, e анат.
retrocecalis |  retrocecalis, e анат.
retrocervicalis |  retrocervicalis, e анат.
retroduodenalis |  retroduodenalis, e анат.
retroesophagealis |  retroesophagealis, e анат.
retroflexio |  retroflexio, onis f
retroflexus |  retroflexus, a, um анат.
retrogradus |  retrogradus, a, um мед.
retrogressus |  retrogressus, a, um анат.
retrohyoideus |  retrohyoideus, a, um анат.
retrolentiformis |  retrolentiformis, e анат.
retrolingualis |  retrolingualis, e анат.
retromammalis |  retromammalis, e анат.
retromandibularis |  retromandibularis, e анат.
retromastoidalis |  retromastoidalis, e анат.
retronasalis |  retronasalis, e анат.
retroperitonealis |  retroperitonealis, e анат.
retropharyngeus |  retropharyngeus, a, um анат.
retropubicus |  retropubicus, a, um анат.
retrorsum |  retrorsum adv.
retrosternalis |  retrosternalis, e анат.
retroversio |  retroversio, onis f
retroversus |  retroversus, a, um
retrusus |  retrusus, a, um
retundo |  retundo, tudi, tusum (tunsum), ere
Reumoidum |  Reumoid(um, i n
reuniens |  reuniens, entis
reus |  reus, i m
revalesco |  revalesco, valui, --, ere
revehens |  revehens, entis
reveho |  reveho, vexi, vectum, ere pass.
revello |  revello, velli, vulsum, ere
revelo |  revelo, avi, atum, are
revenio |  revenio, veni, ventum, ire
reverbero |  reverbero, --, --, are pass.
reverendus |  reverendus, a, um
reverens |  reverens, entis
reverentia |  reverentia, ae f
revereor |  revereor, veritus sum, eri
Reverinum |  Reverin(um, i n
reversio |  reversio (revorsio), onis f
reverto |  reverto (revorto), verti (vorti), versum (vorsum), ere
revertor |  revertor (revortor), versus (vorsus) sum, verti (vorti)
Revibolum |  Revibol(um, i n
revincio |  revincio, vinxi, vinctum, ire
revinco |  revinco, vici, victum, ere
reviresco |  reviresco, virui, --, ere
reviso |  reviso, visi, visum, ere
revivisco |  revivisco, vixi, --, ere
revocabilis |  revocabilis, e
revocamen |  revocamen, inis n
revocatio |  revocatio, onis f
revoco |  revoco, avi, atum, are юр.
revolo |  revolo, avi, atum, are
revolubilis |  revolubilis, e
revolvo |  revolvo, volvi, volutum, ere поэт.
revomo |  revomo, vomui, --, ere
Revonalum |  Revonal(um, i n
revort |  revort...
rex |  rex, regis m
Rexiodum |  Rexiod(um, i n
Rexocainum |  Rexocain(um, i n
Rhadamanthus |  Rhadamanthus, i m
Rhaeti |  Rhaeti, orum m
Rhaetia |  Rhaetia, ae f
Rhaetocainum |  Rhaetocain(um, i n
Rhamnilum |  Rhamnil(um, i n
Rhamnus |  Rhamnus, i f
rhapsodia |  rhapsodia, ae f
Rhea |  Rhea, ae f
rhed |  rhed...
rheno |  rheno, onis m
Rhenus |  Rhenus, i m
Rheopakum |  Rheopak(um, i n
Rheopolyglucinum |  Rheopolyglucin(um, i n
Rheopyrinum |  Rheopyrin(um, i n
Rheosolonum |  Rheosolon(um, i n
rhetor |  rhetor, oris m
rhetorice |  rhetorice adv.
rhetoricoteros |  rhetoricoteros  adj.
rhetoricus |  rhetoricus, a, um
Rheum |  Rheum, i n
rhinalis |  rhinalis, e анат.
rhinanthus |  I rhinanthus, a, um биолог.
Rhinazinum |  Rhinazin(um, i n
Rhinchophorus |  Rhinchophorus, i m
rhinencephalon |  rhinencephalon, i n
rhinitis |  rhinitis, idis f
Rhinoceros |  Rhinoceros, otis m
rhinocerus |  rhinocerus, a, um биолог.
rhinolithus |  rhinolithus, i m
rhinopathia |  rhinopathia, ae f
rhinoplastica |  rhinoplastica, ae f
rhinorrhagia |  rhinorrhagia, ae f
rhinorrhoea |  rhinorrhoea, ae f
rhinoscopia |  rhinoscopia, ae f
Rhipaeus |  Rhipaeus (Rhiphaeus, Ripaeus), a, um
rhis |  rhis, rhinos f
rhizocarpus |  rhizocarpus, a, um биолог.
Rhizocephala |  Rhizocephala, orum n
rhizoma |  rhizoma, atis n
rhizomorphus |  rhizomorphus, a, um биолог.
Rhizopoda |  Rhizopoda, orum n
rho |  rho n
Rhodanus |  Rhodanus, i m
Rhodos |  Rhodos (-us), i f
rhombencephalon |  rhombencephalon, i n
rhomboides |  rhomboides, is
rhomboideus |  rhomboideus, a, um анат.
rhombus |  rhombus, i m
Rhynchophorus |  Rhynchophorus, i m
rhythmici |  rhythmici, orum m
Riboflavinum |  Riboflavin(um, i n
Ribonucleasum |  Ribonucleas(um, i n
Ribovinum |  Ribovin(um, i n
ricinium |  ricinium (recinium), i n
Ricinus |  Ricinus, i m
rictum |  rictum, i n
rictus |  rictus, us m
rideo |  rideo, risi, risum, ere поэт.
ridicule |  ridicule adv.
ridiculus |  ridiculus, a, um
Ridinolum |  Ridinol(um, i n
Ridolum |  Ridol(um, i n
Rifadinum |  Rifadin(um, i n
Rifampicinum |  Rifampicin(um, i n
Rifamycinum |  Rifamycin(um, i n
Rifocinum |  Rifocin(um, i n
Rifodinum |  Rifodin(um, i n
Rigedalum |  Rigedal(um, i n
Rigenicidum |  Rigenicid(um, i n
rigeo |  rigeo, --, --, ere поэт.
rigesco |  rigesco, rigui, --, ere
Rigetaminum |  Rigetamin(um, i n
rigide |  rigide adv.
rigidus |  rigidus, a, um поэт.
rigo |  rigo, avi, atum, are
rigor |  rigor, oris m
riguus |  riguus, a, um pass.
Rilatinum |  Rilatin(um, i n
rima |  rima, ae f
Rimactanum |  Rimactan(um, i n
Rimicidum |  Rimicid(um, i n
Rimifonum |  Rimifon(um, i n
rimor |  rimor, atus sum, ari
rimosus |  rimosus, a, um
Rincortenum |  Rincorten(um, i n
ringor |  ringor, --, ringi
ripa |  ripa, ae f
ripula |  ripula, ae f
risor |  risor, oris m
Risordanum |  Risordan(um, i n
risorius |  risorius, a, um анат.
Ristomycinum |  Ristomycin(um, i n
Ristozetinum |  Ristozetin(um, i n
risus |  risus, us m
Ritalinum |  Ritalin(um, i n
rite |  rite adv.
Rithmosum |  Rithmos(um, i n
ritualis |  ritualis, e
ritus |  ritus, us m
rivalis |  rivalis, is m
rivalitas |  rivalitas, atis f
Rivanolum |  Rivanol(um, i n
Rivivolum |  Rivivol(um, i n
rivulus |  rivulus, i m
rivus |  rivus, i m
rixa |  rixa, ae f
rixor |  rixor, atus sum, ari
robigo |  robigo (rubigo), inis f
roboreus |  roboreus, a, um
roboro |  roboro, avi, atum, are
robur |  robur, oris n
robustus |  robustus, a, um
rodo |  rodo, rosi, rosum, ere
roentgenogramma |  roentgenogramma, atis n
roentgenographia |  roentgenographia, ae f
roentgenologia |  roentgenologia, ae f
roentgenologicus |  roentgenologicus, a, um мед.
rogalis |  rogalis, e
rogatio |  rogatio, onis f
rogatiuncula |  rogatiuncula, ae f
rogator |  rogator, oris m
rogatus |  rogatus, us m
Rogitinum |  Rogitin(um, i n
rogito |  rogito, avi, atum, are
rogo |  rogo, avi, atum, are воен.
rogus |  rogus, i m
Roma |  Roma, ae f
Romanus |  I Romanus, i m
Rometinum |  Rometin(um, i n
Romicilum |  Romicil(um, i n
Romparkinum |  Romparkin(um, i n
Romulidae |  Romulidae, arum (um) m
Romulus |  Romulus, i m
Romycilum |  Romycil(um, i n
Rondarum |  Rondar(um, i n
Rondomycinum |  Rondomycin(um, i n
Ronqualonum |  Ronqualon(um, i n
Rontonum |  Ronton(um, i n
Ronylum |  Ronyl(um, i n
Roquinum |  Roquin(um, i n
rorarii |  rorarii, orum m
roro |  roro, avi, atum, are impers.
ros |  ros, roris m
rosa |  rosa, ae f
rosarium |  rosarium, i n
roscidus |  roscidus, a, um поэт.
rosetum |  rosetum, i n
roseus |  roseus, a, um
rosmarinus |  rosmarinus
rostra |  rostra, orum n
rostralis |  rostralis, e анат.
rostratus |  rostratus, a, um
rostriformis |  rostriformis, e биолог.
rostrum |  rostrum, i n
rota |  rota, ae f
rotatio |  rotatio, onis f
rotator |  rotator, oris m
Roterum |  Roter(um, i n
roto |  roto, avi, atum, are pass.
rotunde |  rotunde adv.
rotundifolius |  rotundifolius, a, um биолог.
rotundo |  rotundo, avi, atum, are поэт.
rotundus |  rotundus, a, um
Rovacholexum |  Rovacholex(um, i n
Rovamycinum |  Rovamycin(um, i n
Rovatinexum |  Rovatinex(um, i n
Roxinoidum |  Roxinoid(um, i n
Rubavitum |  Rubavit(um, i n
rubefacio |  rubefacio, feci, factum, ere
rubens |  rubens, entis
rubeo |  rubeo, rubui, --, ere
ruber |  ruber, bra, brum
rubesco |  rubesco, rubui, --, ere
rubetum |  rubetum, i n
rubeus |  rubeus, a, um
Rubia |  Rubia, ae f
Rubico |  Rubico, onis m
rubicundus |  rubicundus, a, um
Rubidomycinum |  Rubidomycin(um, i n
rubigo |  rubigo
Rubivitanum |  Rubivitan(um, i n
rubor |  rubor, oris m
Rubraminum |  Rubramin(um, i n
rubrica |  rubrica, ae f
rubriflorus |  rubriflorus, a, um биолог.
rubrofuscus |  rubrofuscus, a, um биолог.
rubroreticularis |  rubroreticularis, e анат.
rubrospinalis |  rubrospinalis, e анат.
rubus |  rubus, i m
Rucetinum |  Rucetin(um, i n
ructo |  ructo, avi, atum, are
ructor |  ructor, atus sum, ari
ructus |  ructus, us m
rudens |  rudens, entis m
rudimentum |  rudimentum, i n
rudis |  I rudis, e f
rudo |  rudo, rudivi, --, ere поэт.
rudus |  I rudus n
ruficaudatus |  ruficaudatus, a, um биолог.
ruficaudus |  ruficaudus, a, um биолог.
ruficollis |  ruficollis, e биолог.
rufus |  rufus, a, um
ruga |  ruga, ae f
rugosus |  rugosus, a, um
ruina |  ruina, ae f
ruinosus |  ruinosus, a, um поэт.
Rumina |  Rumina, ae f
Ruminalis |  Ruminalis ficus f
ruminatio |  ruminatio, onis f
rumino |  rumino, --, --, are
rumor |  rumor, oris m
rumpia |  rumpia, ae f
rumpo |  rumpo, rupi, ruptum, ere pass.
rumusculus |  rumusculus, i m
ruo |  ruo, rui, rutum, ere part.
rupes |  rupes, is f
rupicapra |  rupicapra, ae f
ruptor |  ruptor, oris m
ruptura |  ruptura, ae f
ruricola |  ruricola, ae m
rurigena |  rurigena, ae m
rurigenae |  rurigenae, arum m
rursus |  rursus adv.
rus |  rus, ruris n
ruscum |  ruscum, i n
Ruspirinum |  Ruspirin(um, i n
rustica |  rustica, ae f
rusticanus |  rusticanus, a, um
rusticatio |  rusticatio, onis f
rustice |  rustice adv.
rusticitas |  rusticitas, atis f
rusticor |  rusticor, --, ari
rusticulus |  rusticulus, i m
rusticus |  I rusticus, a, um m
ruta |  ruta, ae f
Rutabionum |  Rutabion(um, i n
Rutaminum |  Rutamin(um, i n
rutilo |  rutilo, avi, atum, are
rutilus |  rutilus, a, um
Rutinum |  Rutin(um, i n
Rutophyllinum |  Rutophyllin(um, i n
Rutosidum |  Rutosid(um, i n
rutrum |  rutrum, i n
rutula |  rutula, ae f
Ruvitum |  Ruvit(um, i n
rynchophyllus |  rynchophyllus, a, um биолог.
