sabbata |  sabbata, orum n
Sabelli |  Sabelli, orum m
Sabini |  Sabini, orum m
sabulum |  sabulum, i n
saburra |  saburra, ae f
Saccharinum |  Saccharin(um, i n
Saccharum |  Saccharum, i n
sacciformis |  sacciformis, e анат.
Saccoglossa |  Saccoglossa, orum n
Saccopteryx |  Saccopteryx, igis f
saccularis |  saccularis, e анат.
sacculus |  sacculus, i m
saccus |  saccus, i m
sacellum |  sacellum, i n
sacer |  sacer, cra, crum поэт.
sacerdos |  sacerdos, otis m
sacerdotium |  sacerdotium, i n
sacralis |  sacralis, e анат.
sacramentum |  sacramentum, i n
sacrarium |  sacrarium, i n
sacratus |  sacratus, a, um
sacrifer |  sacrifer, era, erum
sacrificium |  sacrificium, i n
sacrifico |  sacrifico, avi, atum, are
sacrificulus |  sacrificulus, i m
sacrificus |  sacrificus, a, um поэт.
sacrilegium |  sacrilegium, i n
sacrilegus |  sacrilegus, a, um
sacrinae |  sacrinae, arum f
sacro |  sacro, avi, atum, are поэт.
sacrococcygeus |  sacrococcygeus, a, um анат.
sacroiliacus |  sacroiliacus, a, um анат.
sacropelvinus |  sacropelvinus, a, um анат.
sacrosanctus |  sacrosanctus, a, um
sacrospinalis |  sacrospinalis, e анат.
sacrotuberalis |  sacrotuberalis, e анат.
sacrum |  sacrum, i n
saeclum |  saeclum, i n
saecularis |  saecularis, e
saeculum |  saeculum (saeclum), i n
saepe |  saepe ( compar.
saepenumero |  saepenumero adv.
saepes |  saepes (sepes), is f
saepimentum |  saepimentum, i n
saepio |  saepio, saepsi, saeptum, ire
saeptum |  saeptum, i n
saet |  saet...
saeve |  saeve adv.
saevio |  saevio, saevli, saevitum, ire
saevitia |  saevitia, ae f
saevus |  saevus, a, um
saga |  saga, ae f
sagacitas |  sagacitas, atis f
sagaciter |  sagaciter adv.
sagatus |  sagatus, a, um
sagax |  sagax, acis
sagina |  sagina, ae f
sagino |  sagino, avi, atum, are
sagitta |  sagitta, ae f
sagittalis |  sagittalis, e анат.
sagittarius |  sagittarius, i m
sagittifer |  sagittifer, era, erum
sagittipotens |  sagittipotens, entis
sagmen |  sagmen, inis n
sagulum |  sagulum, i n
sagum |  sagum, i n
Saguntum |  Saguntum, i n
Saiodinum |  Saiodin(um, i n
sal |  I sal, salis m
Salamidum |  Salamid(um, i n
Salamina |  Salamina, ae acc.
Salaphtholum |  Salaphthol(um, i n
salarium |  salarium, i n
salarius |  salarius, a, um
salax |  salax, acis поэт.
Salazodimethoxinum |  Salazodimethoxin(um, i n
Salazopyridazinum |  Salazopyridazin(um, i n
Salazopyridinum |  Salazopyridin(um, i n
Salazopyrinum |  Salazopyrin(um, i n
Salazosulfapyridinum |  Salazosulfapyridin(um, i n
Salbutamolum |  Salbutamol(um, i n
salebra |  salebra, ae f
salebrosus |  salebrosus, a, um
Salernum |  Salernum, i n
Saletinum |  Saletin(um, i n
Saliamidum |  Saliamid(um, i n
Salicinum |  Salicin(um, i n
salictum |  salictum, i n
Salicylamidum |  Salicylamid(um, i n
Salicylanilidum |  Salicylanilid(um, i n
salicylas |  salicylas, atis m
salicylatus |  salicylatus, a, um хим.
Salicylazosulfapyridinum |  Salicylazosulfapyridin(um, i n
salicylicus |  salicylicus, a, um хим.
Saliglutinum |  Saliglutin(um, i n
salignus |  salignus, a, um
Salii |  Salii, orum m
Salimidum |  Salimid(um, i n
salinae |  salinae, arum f
Salinimentum |  Saliniment(um, i n
salinum |  salinum, i n
salio |  I salio (sallio), (ii), itum, ire
Salitinum |  Salitin(um, i n
saliunca |  saliunca, ae f
saliva |  saliva, ae f
salivalis |  salivalis, e анат.
salivatorius |  salivatorius, a, um анат.
Salix |  Salix, icis f
salix |  salix, icis f
sallio |  sallio
sallo |  I sallo
Sallustius |  Sallustius, a, um
Salolum |  Salol(um, i n
Salopurum |  Salopur(um, i n
salpa |  salpa, ae f
salpingectomia |  salpingectomia, ae f
salpingitis |  salpingitis, idis f
salpingographia |  salpingographia, ae f
salpingolysis |  salpingolysis, is f
salpingopalatinus |  salpingopalatinus, a, um анат.
salpingopharyngeus |  salpingopharyngeus, a, um анат.
salpingostomia |  salpingostomia, ae f
salpingotomia |  salpingotomia, ae f
salpinx |  salpinx, ingis f
salse |  salse adv.
Salsola |  Salsola, ae f
Salsolidinum |  Salsolidin(um, i n
Salsolinum |  Salsolin(um, i n
salsus |  salsus, a, um
saltatio |  saltatio, onis f
saltator |  saltator, oris m
saltatorius |  saltatorius, a, um
saltatrix |  saltatrix, icis f
saltatus |  saltatus, us m
saltem |  saltem (saltim) adv.
salto |  salto, avi, atum, are
saltuarius |  saltuarius, i m
saltuosus |  saltuosus, a, um
saltus |  I saltus, us m
saluber |  saluber, bris, bre
salubritas |  salubritas, atis f
salubriter |  salubriter adv.
salum |  salum, i n
salus |  salus, utis f
salutaris |  salutaris, e
salutariter |  salutariter adv.
salutatio |  salutatio, onis f
salutator |  salutator, oris m
salutifer |  salutifer, era, erum
saluto |  saluto, avi, atum, are
Saluzidum |  Saluzid(um, i n
salvatella |  salvatella, ae f
salve |  salve adv.
salveo |  salveo, --, --, ere
Salvia |  Salvia, ae f
salvus |  salvus, a, um
Samarobriva |  Samarobriva, ae f
sambuca |  sambuca, ae f
sambucistria |  sambucistria, ae f
Samnites |  Samnites, ium m
Samnium |  Samnium, i n
Samos |  Samos (-us), i f
sanabilis |  sanabilis, e
sanatio |  sanatio, onis f
sancio |  sancio, sancii (sanxi), sancitum (sanctum), ire
sanctas |  sanctas, a, um
sancte |  sancte adv.
sanctimonia |  sanctimonia, ae f
sanctio |  sanctio, onis f
sanctitas |  sanctitas, atis f
sandix |  sandix, icis f
Sandopartum |  Sandopart(um, i n
sandyx |  sandyx, ycis m
sane |  sane adv.
Sanedrinum |  Sanedrin(um, i n
Sanepilum |  Sanepil(um, i n
Sangostasinum |  Sangostasin(um, i n
sanguifer |  sanguifer, era, erum
sanguineus |  sanguineus, a, um анат.
sanguinolentus |  sanguinolentus, a, um
sanguis |  sanguis, inis m
Sanguisorba |  Sanguisorba, ae f
sanies |  sanies, ei f
sanitas |  sanitas, atis f
sano |  sano, avi, atum, are
Sanoquinum |  Sanoquin(um, i n
Sanorinum |  Sanorin(um, i n
Sanotensinum |  Sanotensin(um, i n
Santobanum |  Santoban(um, i n
Santones |  Santones, um m
Santoninum |  Santonin(um, i n
sanus |  sanus, a, um
saphenus |  saphenus, a, um анат.
sapiens |  I sapiens, entis m
sapienter |  sapienter adv.
sapientia |  sapientia, ae f
sapio |  sapio, ii (ivi, ui), --, ere
sapo |  sapo, onis m
saponatus |  saponatus, a, um
sapor |  sapor, oris m
Sappho |  Sappho, us f
saprophagus |  saprophagus, a, um биолог.
saprophyton |  saprophyton, i n
Saprosanum |  Saprosan(um, i n
sarcina |  sarcina, ae f
sarcinarius |  sarcinarius, a, um
sarcio |  sarcio, sarsi, sartum, ire
Sarcoclorinum |  Sarcoclorin(um, i n
sarcolemma |  sarcolemma, atis n
Sarcolysinum |  Sarcolysin(um, i n
Sarcomycinum |  Sarcomycin(um, i n
sarcoplasma |  sarcoplasma, atis n
sarculum |  sarculum, i n
Sardes |  Sardes (Sardis), ium f
sargus |  sargus, i m
sarisa |  sarisa (sarissa), ae f
sarisophorus |  sarisophorus, i m
Sarmatae |  Sarmatae, arum m
sarmentum |  sarmentum, i n
Sarodorminum |  Sarodormin(um, i n
Sarotenum |  Saroten(um, i n
Sarotexum |  Sarotex(um, i n
Sarracinum |  Sarracin(um, i n
sartor |  sartor, oris m
sartorius |  sartorius, a, um анат.
sat |  sat adv.
sata |  sata, orum n
satago |  satago, --, --, ere
satelles |  I satelles, itis m
satias |  satias, atis f
satietas |  satietas, atis f
satin |  satin' см.
satio |  I satio, avi, atum, are f
satira |  satira, ae f
satis |  satis compar.
satisdatio |  satisdatio, onis f
satisdo |  satisdo, dedi, datum, dare
satisfacio |  satisfacio, feci, factum, ere
satisfactio |  satisfactio, onis f
satius |  satius см.
sator |  sator, oris m
satrapes |  satrapes, ae acc.
satur |  satur, ura, urum поэт.
satura |  satura, ae f
satureja |  satureja, ae f
Saturnalia |  Saturnalia, orum (ium) n
Saturninus |  Saturninus, i m
Saturnus |  Saturnus, i m
saturo |  saturo, avi, atum, are
satus |  I satus, a, um part.
satyra |  satyra
Satyrus |  Satyrus, i m
sauciatio |  sauciatio, onis f
saucio |  saucio, avi, atum, are
saucius |  saucius, a, um поэт.
savillum |  savillum, i n
savior |  savior, atus sum, ari
savium |  savium, i n
saxatilis |  saxatilis, e
saxetum |  saxetum, i n
saxeus |  saxeus, a, um
saxicola |  saxicola, ae f
saxificus |  saxificus, a, um
Saxifraga |  Saxifraga, ae f
saxosus |  saxosus, a, um
saxum |  saxum, i n
scabellum |  scabellum (scabillum), i n
scaber |  scaber, bra, brum
scabies |  scabies, ei f
scabillum |  scabillum, i n
scabo |  scabo, scabi, --, ere
Scaea |  Scaea porta f
scaena |  scaena, ae f
scaeptrum |  scaeptrum
Scaevola |  Scaevola, ae m
scaevus |  scaevus, a, um
scala |  scala, ae f
scalae |  scalae, arum f
Scaldis |  Scaldis, is m
scalenus |  scalenus, a, um анат.
scalmus |  scalmus, i m
scalpellum |  scalpellum, i n
scalpo |  scalpo, scalpsi, scalptum, ere
scalprum |  scalprum, i n
scammonia |  scammonia (scammonea), ae f
scamnum |  scamnum, i n
scando |  scando, scandi, scansum, ere
scandula |  scandula, ae f
scapha |  scapha, ae f
scaphium |  scaphium (scapium), i n
scaphocuboideus |  scaphocuboideus, a, um анат.
scaphoideocuneiformis |  scaphoideocuneiformis, e анат.
scaphoideus |  scaphoideus, a, um анат.
scapula |  scapula, ae f
scapulae |  scapulae, arum f
scapularis |  scapularis, e анат.
scapus |  scapus, i m
scarus |  scarus, i m
scatebra |  scatebra, ae f
scateo |  scateo, --, --, ere
scaturigo |  scaturigo, inis f
scaurus |  scaurus, a, um
scelerate |  scelerate adv.
sceleratus |  sceleratus, a, um
scelero |  scelero, avi, atum, are
sceleste |  sceleste adv.
scelestus |  scelestus, a, um
sceleton |  sceleton, i n
scelus |  scelus, eris n
Scemedinum |  Scemedin(um, i n
scena |  scena (scaena), ae f
scenicus |  scenicus, a, um
sceptrifer |  sceptrifer, era, erum
sceptrum |  sceptrum (scaeptrum), i n
scheda |  scheda (scida), ae f
schedula |  schedula, ae f
schisma |  schisma, atis n
Schistosoma |  Schistosoma, atis n
Schizandra |  Schizandra, ae f
schizogonia |  schizogonia, ae f
schola |  schola, ae f
scholasticus |  I scholasticus, a, um m
schyndilesis |  schyndilesis, is f
scida |  scida
sciens |  sciens, entis
scienter |  scienter adv.
scientia |  scientia, ae f
scilicet |  scilicet adv.
scilla |  scilla, ae f
scindo |  scindo, scidi, scissum, ere pass.
scindula |  scindula
scintilla |  scintilla, ae f
scintillo |  scintillo, avi, --, are
scio |  scio, ivi (ii), itum, ire
scipio |  I scipio, onis m
scirpea |  scirpea (sirpea), ae f
scirpeus |  scirpeus (sirpeus), a, um
scirpus |  scirpus (sirpus), i m
sciscitor |  sciscitor, atus sum, ari
scisco |  scisco, scivi, scitum, ere
scite |  scite adv.
scitor |  scitor, atus sum, ari поэт.
scitum |  scitum, i n
scitus |  I scitus, a, um m
sclera |  sclera, ae f
scleroblasti |  scleroblasti, orum m
sclerodermaticus |  sclerodermaticus, a, um биолог.
Sclerophyllinum |  Sclerophyllin(um, i n
sclerophyllus |  I sclerophyllus, a, um биолог.
sclerosis |  sclerosis, is f
sclopetum |  sclopetum, i n
scobis |  scobis, is f
Scolinum |  Scolin(um, i n
scoliosis |  scoliosis, is f
scopa |  scopa, ae f
Scopas |  Scopas, ae m
Scopolaminum |  Scopolamin(um, i n
scopulosus |  scopulosus, a, um
scopulus |  scopulus, i m
scorpio |  scorpio, onis (scorpios, i) m
scortator |  scortator, oris m
scortea |  scortea, orum n
scorteus |  scorteus, a, um
scortor |  scortor, --, --, ari
scortum |  scortum, i n
scriba |  scriba, ae m
scribo |  scribo, scripsi, scriptum, ere юр.
scrinium |  scrinium, i n
scriptito |  scriptito, avi, atum, are
scriptor |  scriptor, oris m
scriptorius |  scriptorius, a, um анат.
scriptulum |  scriptulum, i n
scriptum |  scriptum, i n
scriptura |  scriptura, ae f
scriptus |  scriptus, us m
scripulum |  scripulum (scrupulum), i n
scrobis |  scrobis, is m
scrofa |  scrofa, ae f
scrotalis |  scrotalis, e анат.
scrotum |  scrotum, i n
scrupeus |  scrupeus, a, um
scrupulosus |  scrupulosus, a, um
scrupulum |  scrupulum, i n
scrupulus |  scrupulus (scripulus), i m
scruta |  scruta, orum n
scrutor |  scrutor, atus sum, ari
sculpo |  sculpo, sculpsi, sculptum, ere
sculptilis |  sculptilis, e
scurra |  scurra, ae m
scurrilis |  scurrilis, e
scurrilitas |  scurrilitas, atis f
scurror |  scurror, --, ari
scutale |  scutale, is n
Scutamilum |  Scutamil(um, i n
scutati |  scutati, orum m
scutatus |  scutatus, a, um
Scuteliaria |  Scuteliaria, ae f
scutica |  scutica, ae f
scutifer |  scutifer, era, erum биолог.
scutula |  scutula, ae f
scutum |  scutum, i n
Scylla |  Scylla, ae f
scyphos |  scyphos, i m
Scythae |  Scythae, arum m
Scythia |  Scythia, ae f
se |  I se (sed) praep.
sebaceus |  sebaceus, a, um анат.
Sebidinum |  Sebidin(um, i n
Sebizonum |  Sebizon(um, i n
sebolithus |  sebolithus, i m
seborrhoea |  seborrhoea, ae f
sebum |  sebum, i n
Secabrevinum |  Secabrevin(um, i n
Secale |  Secale, is n
secedo |  secedo, cessi, cessum, ere
secerno |  secerno, crevi, cretum, ere
secessio |  secessio, onis f
secessus |  secessus, us m
secludo |  secludo, clusi, clusum, ere
seclum |  seclum, i n
seco |  seco, cui, ctum, are part.
Secometrinum |  Secometrin(um, i n
Secotaminum |  Secotamin(um, i n
secretio |  secretio, onis f
secreto |  secreto adv.
secretorius |  secretorius, a, um анат.
secretum |  I secretum, i n
secretus |  secretus, a, um
secta |  secta, ae f
sectator |  sectator, oris m
sectilis |  sectilis, e
sectio |  sectio, onis f
sector |  I sector, atus sum, ari m
secubitus |  secubitus, us m
secubo |  secubo, bui, --, are
secularis |  secularis
seculum |  seculum
secum |  secum см.
secundani |  secundani, orum m
secundo |  I secundo adv.
secundum |  I secundum praep.
secundus |  secundus, a, um поэт.
securifer |  securifer, era, erum
securiger |  securiger, era, erum
Securininum |  Securinin(um, i n
securis |  securis, is f
securitas |  securitas, atis f
securus |  securus, a, um поэт.
secus |  I secus ( compar.
sed |  sed ( арх.
Sedalginum |  Sedalgin(um, i n
Sedalum |  Sedal(um, i n
Sedanylum |  Sedanyl(um, i n
Sedaraupinum |  Sedaraupin(um, i n
Sedatinum |  Sedatin(um, i n
sedatio |  sedatio, onis f
sedatus |  sedatus, a, um
Sedazilum |  Sedazil(um, i n
sedecim |  sedecim (sexdecim)
sedecula |  sedecula, ae f
sedeo |  sedeo, sedi, --, ere воен.
sedes |  sedes, is f
Sedevalum |  Sedeval(um, i n
sedile |  sedile, is n
Sedistonum |  Sediston(um, i n
seditio |  seditio, onis f
seditiose |  seditiose adv.
seditiosus |  seditiosus, a, um
Sedivalum |  Sedival(um, i n
sedo |  sedo, avi, atum, are
Sedonalum |  Sedonal(um, i n
Sedoxazinum |  Sedoxazin(um, i n
Sedralum |  Sedral(um, i n
seduco |  seduco, duxi, ductum, ere
seductio |  seductio, onis f
seductus |  seductus, a, um
sedulitas |  sedulitas, atis f
sedulo |  sedulo adv.
sedulus |  sedulus, a, um
Seduralum |  Sedural(um, i n
Seduxenum |  Seduxen(um, i n
seges |  seges, etis f
segmentalis |  segmentalis, e анат.
segmentatio |  segmentatio, onis f
segmentum |  segmentum, i n
segnis |  segnis, e
segniter |  segniter adv.
segnitia |  segnitia, ae f
Segontinum |  Segontin(um, i n
segrego |  segrego, avi, atum, are
Segurilum |  Seguril(um, i n
sejuges |  sejuges, ium m
sejugis |  sejugis, e
sejunctio |  sejunctio, onis f
sejungo |  sejungo, junxi, junctum, ere pass.
selectio |  selectio, onis f
selibra |  selibra, ae f
seligo |  seligo, legi, lectum, ere
sella |  sella, ae f
sellaris |  sellaris, e анат.
sellularius |  sellularius, i m
semaphorum |  semaphorum, i n
semel |  semel adv.
Semela |  Semela, ae f
semen |  semen, inis n
semenstris |  semenstris
sementifer |  sementifer, era, erum
sementis |  sementis, is f
sementivus |  sementivus, a, um
semermis |  semermis
semermus |  semermus
semestris |  semestris (semenstris), e
semesus |  semesus (semiesus), a, um
semet |  semet см.
semiadapertus |  semiadapertus, a, um
semianimis |  semianimis, e
semiapertus |  semiapertus, a, um
semibarbarus |  semibarbarus, a, um
semibos |  semibos, ovis m
semicanalis |  semicanalis, is m
semicaper |  semicaper, apri m
semicircularis |  semicircularis, e анат.
semicrematus |  semicrematus, a, um
semicremus |  semicremus, a, um
semicubitalis |  semicubitalis, e
semidecussatio |  semidecussatio, onis f
semideus |  semideus, a, um
semidoctus |  semidoctus, a, um
semiermis |  semiermis (semermis), e
semiesus |  semiesus
semifactus |  semifactus, a, um
semifer |  semifer, era, erum
semigermanus |  semigermanus, a, um
semigravis |  semigravis, e
semigro |  semigro, avi, --, are
semihomo |  semihomo, inis m
semihora |  semihora, ae f
semilacer |  semilacer, cra, crum
semiliber |  semiliber, era, erum
semilixa |  semilixa, ae m
semilunaris |  semilunaris, e анат.
semimas |  semimas, aris m
semimembranosus |  semimembranosus, a, um анат.
seminalis |  seminalis, e анат.
seminarium |  seminarium, i n
seminator |  seminator, oris m
seminex |  seminex, ecis
seminifer |  seminifer, erа, erum
semino |  semino, avi, atum, are поэт.
seminudus |  seminudus, a, um
semiovalis |  semiovalis, e анат.
Semiplacentinus |  Semiplacentinus, i m
semiplenus |  semiplenus, a, um
semiputatus |  semiputatus, a, um
Semiramis |  Semiramis, idis (idos) f
semireductus |  semireductus, a, um
semirefectus |  semirefectus, a, um
semiruta |  semiruta, orum n
semirutus |  semirutus, a, um
semis |  semis, issis m
semisepultus |  semisepultus, a, um
semisomnus |  semisomnus, a, um
semispinalis |  semispinalis, e анат.
semisupinus |  semisupinus, a, um
semita |  semita, ae f
semitalis |  semitalis, e
semitendinosus |  semitendinosus, a, um анат.
semitransitorius |  semitransitorius, a, um биолог.
semiuncia |  semiuncia, ae f
semiunciarius |  semiunciarius, a, um
semiustulatus |  semiustulatus
semiustus |  semiustus (semustus), a, um
semivir |  semivir, viri m
semivivus |  semivivus, a, um
semotus |  semotus, a, um
semoveo |  semoveo, movi, motum, ere
semper |  semper adv.
sempiternus |  sempiternus, a, um
Sempronius |  Sempronius, a, um
semul |  semul
semustulatus |  semustulatus (semiustulatus), a, um
semustus |  semustus, a, um
senaculum |  senaculum, i n
senarius |  I senarius, a, um m
senator |  senator, oris m
senatorius |  senatorius, a, um
senatus |  senatus, us ( арх.
Sendoxanum |  Sendoxan(um, i n
Seneca |  Seneca, ae m
Senecio |  Senecio, onis f
senecta |  senecta, ae f
senectus |  I senectus, a, um f
senesco |  senesco, senui, --, ere
senex |  I senex, senis compar.
seni |  seni, ae, a
senilis |  senilis, e
senior |  senior, oris m
senium |  senium, i n
seniuncia |  seniuncia, ae f
Senones |  Senones, um m
sensim |  sensim adv.
sensitivus |  sensitivus, a, um
sensorius |  sensorius, а, um
sensus |  sensus, us m
sententia |  sententia, ae f
sententiola |  sententiola, ae f
Senthadilum |  Senthadil(um, i n
sentina |  sentina, ae f
sentio |  sentio, sensi, sensum, ire юр.
sentis |  sentis, is m
Sentonylum |  Sentonyl(um, i n
sentus |  sentus, a, um
seorsus |  seorsus adv.
separatim |  separatim adv.
separatio |  separatio, onis f
separatus |  separatus, a, um
separo |  separo, avi, atum, are
sepelio |  sepelio, pelivi (pelii), pultum, ire поэт.
sepes |  sepes
sepimentum |  sepimentum, i n
sepio |  sepio
sepono |  sepono, posui, positum, ere поэт.
sepse |  sepse
septalis |  septalis, e анат.
Septazilum |  Septazil(um, i n
septem |  septem
September |  I September, bris, bre abl.
septemdecim |  septemdecim (septendecim)
septemfluus |  septemfluus, a, um
septemjugatus |  septemjugatus, a, um биолог.
septemplex |  septemplex, icis
septemtrio |  septemtrio (septemptrio, septentrio), onis m
septemtrionalis |  septemtrionalis, e
septemvir |  septemvir, viri m
septemviralis |  septemviralis, e
septemviratus |  septemviratus, us m
septenarius |  septenarius, a, um
septendecim |  septendecim
septeni |  septeni, ae, a
septentr |  septentr...
septicus |  septicus, a, um мед.
septies |  septies (septiens) adv.
septimum |  septimum adv.
septimus |  septimus (septumus), a, um
septingentesimus |  septingentesimus, a, um
septingenti |  septingenti, ae, a
septomarginalis |  septomarginalis, e анат.
septuagesimus |  septuagesimus, a, um
septuaginta |  septuaginta
septulum |  septulum, i n
septum |  I septum, i n
septumus |  septumus
septunx |  septunx, uncis m
septus |  septus, a, um анат.
sepulcralis |  sepulcralis (sepulchralis), e
sepulcrum |  sepulcrum (sepulchrum), i n
sepultura |  sepultura, ae f
Sequana |  Sequana, ae m
sequando |  sequando adv.
Sequani |  Sequani, orum m
sequax |  sequax, acis поэт.
sequester |  I sequester, tra, trum m
Sequestrenum |  Sequestren(um, i n
sequor |  sequor, secutus (sequutus) sum, sequi
sera |  sera, ae f
Serenacum |  Serenac(um, i n
Serenalum |  Serenal(um, i n
serenitas |  serenitas, atis f
sereno |  sereno, avi, atum, are
serenum |  serenum, i n
serenus |  serenus, a, um
Sergosinum |  Sergosin(um, i n
seria |  seria, ae f
sericus |  sericus, a, um фармац.
series |  series, ei f
serio |  serio adv.
serissime |  serissime superl.
serium |  serium, i n
serius |  I serius compar.
sermo |  sermo, onis m
sermocinor |  sermocinor, atus sum, ari
sermunculus |  sermunculus, i m
sero |  I sero adv.
Serociclina |  Serociclina, ae f
seromucosus |  seromucosus, a, um анат.
Seromycinum |  Seromycin(um, i n
serosus |  serosus, a, um анат.
serotinus |  serotinus, a, um
Serotoninum |  Serotonin(um, i n
Serpasilum |  Serpasil(um, i n
Serpatum |  Serpat(um, i n
serpens |  serpens, entis m
serpentigena |  serpentigena, ae m
serpentinus |  serpentinus, a, um
serpentipes |  serpentipes, edis m
Serpenum |  Serpen(um, i n
Serpiloidum |  Serpiloid(um, i n
Serpinum |  Serpin(um, i n
serpo |  serpo, serpsi, serptum, ere
serpyllum |  serpyllum, i n
serra |  serra, ae f
serrati |  serrati, orum m
serratus |  serratus, a, um
serrula |  serrula, ae f
serta |  serta, ae f
Sertanum |  Sertan(um, i n
Sertorius |  Sertorius, a, um
serum |  I serum, i n
serus |  serus, a, um поэт.
serva |  serva, ae f
servabilis |  servabilis, e
servans |  servans, antis
servator |  servator, oris m
servatrix |  servatrix, icis f
servilis |  servilis, e
serviliter |  serviliter adv.
Servilius |  Servilius, a, um
servio |  servio, ivi (ii), itum, ire
servitium |  servitium, i n
servitus |  servitus, utis f
Servius |  Servius, i m
servo |  servo, avi, atum, are поэт.
servolus |  servolus, i m
servula |  servula, ae f
servulus |  servulus (servolus), i m
servus |  I servus, a, um m
sesamoides |  sesamoides, is анат.
sesamoideus |  sesamoideus, a, um
sesceni |  sesceni, ae, a
sescennaris |  sescennaris, e
sesqui |  sesqui adv.
sesquialter |  sesquialter, era, erum
sesquimodius |  sesquimodius, i m
sesquioctavus |  sesquioctavus, a, um
sesquipedalis |  sesquipedalis, e
sessilis |  sessilis, e
sessio |  sessio, onis f
sessor |  sessor, oris m
sestertium |  sestertium, i n
sestertius |  sestertius, i m
Sestius |  Sestius, a, um
set |  set
seta |  seta, ae f
Sethadilum |  Sethadil(um, i n
setiger |  I setiger, era, erum m
setosus |  setosus, a, um
seu |  seu
Sevenalum |  Sevenal(um, i n
severe |  severe adv.
severitas |  severitas, atis f
severus |  I severus, a, um поэт.
Sevicainum |  Sevicain(um, i n
Sevinalum |  Sevinal(um, i n
Sevinolum |  Sevinol(um, i n
Sevinonum |  Sevinon(um, i n
sevoco |  sevoco, avi, atum, are
sevum |  sevum, i n
sex |  sex
sexagenarius |  sexagenarius, a, um
sexageni |  sexageni, ae, a
sexagesimus |  sexagesimus, a, um
sexagies |  sexagies (sexagiens) adv.
sexaginta |  sexaginta
sexangularis |  sexangularis, e биолог.
sexangulus |  sexangulus, a, um
sexapodus |  sexapodus, a, um биолог.
sexcenarius |  sexcenarius, a, um
sexceni |  sexceni (sesceni), ae, a
sexcentesimus |  sexcentesimus, a, um
sexcenti |  sexcenti, ae, a
sexcenties |  sexcenties adv.
sexdecim |  sexdecim
sexennis |  sexennis, e
sexennium |  sexennium, i n
sexies |  sexies (sexiens) adv.
sextans |  sextans, antis m
sextarius |  sextarius, i m
sextilis |  I sextilis, e m
Sextius |  Sextius, a, um
sextula |  sextula, ae f
sextum |  sextum adv.
sextus |  I sextus, a, um m
sexualis |  sexualis, e биолог.
sexus |  sexus, is m
si |  si conj.
sialographia |  sialographia, ae f
sibilo |  sibilo, --, --, are
sibilus |  I sibilus, a, um m
sibiricus |  sibiricus, a, um биолог.
Sibylla |  Sibylla, ae f
Sibyllinus |  Sibyllinus, a, um
sic |  sic adv.
sica |  sica, ae f
Sicani |  Sicani, orum m
Sicania |  Sicania, ae f
sicarius |  sicarius, i m
siccitas |  siccitas, atis f
sicco |  sicco, avi, atum, are поэт.
siccum |  siccum, i n
siccus |  siccus, a, um поэт.
Sicilia |  Sicilia, ae f
sicubi |  sicubi conj.
Siculi |  Siculi, orum m
sicunde |  sicunde conj.
sicut |  sicut (sicuti) adv.
Sicyon |  Sicyon, onis m
sidereus |  sidereus, a, um
sido |  sido, sidi (sedi), sessum, ere
Sidon |  Sidon, onis f
sidus |  sidus, eris n
Sigambri |  Sigambri, orum m
sigillatus |  sigillatus, a, um
sigillum |  sigillum, i n
Sigmamycinum |  Sigmamycin(um, i n
sigmoideus |  sigmoideus, a, um анат.
signator |  signator, oris m
Signemycinum |  Signemycin(um, i n
signifer |  I signifer, era, erum m
significanter |  significanter adv.
significatio |  significatio, onis f
significo |  significo, avi, atum, are
signo |  signo, avi, atum, are
signum |  signum, i n
Silbephyllinum |  Silbephyllin(um, i n
silenda |  silenda, orum n
silentium |  silentium, i n
Silenus |  Silenus, i m
sileo |  sileo, ui, --, ere
siler |  siler, eris n
silesco |  silesco, --, --, ere
silex |  silex, icis m
siliqua |  siliqua, ae f
Silubinum |  Silubin(um, i n
silva |  silva, ae f
Silvanus |  Silvanus, i m
silvester |  silvester, tris, tre поэт.
silvestria |  silvestria, ium n
silvicola |  silvicola, ae m
silvosus |  silvosus, a, um
simia |  simia, ae f
simile |  simile, is n
similis |  similis, e
similiter |  similiter adv.
similitudo |  similitudo, inis f
simius |  simius
simplex |  simplex, icis
simplicitas |  simplicitas, atis f
simpliciter |  simpliciter adv.
simplum |  simplum, i n
simplus |  simplus, a, um
simpulum |  simpulum, i n
simpuvium |  simpuvium, i n
simul |  simul ( арх.
simulacrum |  simulacrum, i n
simulamen |  simulamen, inis n
simulans |  simulans, antis
simulatio |  simulatio, onis f
simulator |  simulator, oris m
simulatus |  simulatus, a, um
simulo |  simulo, avi, atum, are поэт.
simultas |  simultas, atis f
sin |  sin conj.
sinapis |  sinapis, is f
sinapismus |  sinapismus, i m
Sinaplegum |  Sinapleg(um, i n
sincere |  sincere adv.
sinceritas |  sinceritas, atis f
sincerus |  sincerus, a, um
sinciput |  sinciput, itis n
Sincolinum |  Sincolin(um, i n
sine |  sine praep.
Sinestrolum |  Sinestrol(um, i n
singillatim |  singillatim (singulatim) adv.
singula |  singula, orum n
singularis |  singularis, e грам.
singulariter |  singulariter adv.
singulatim |  singulatim
singuli |  singuli, ae, a
singultim |  singultim adv.
singulto |  singulto, (avi), atum, are поэт.
singultus |  singultus, us m
sinister |  sinister, tra, trum
sinistra |  sinistra, ae f
sinistre |  sinistre adv.
sinistrorsus |  sinistrorsus (sinistrorsum) adv.
sinistrum |  sinistrum, i n
sinius |  sinius, a, um
sino |  sino, sivi, situm, ere
Sinoganum |  Sinogan(um, i n
Sinopa |  Sinopa, ae u Sinope, es f
Sinopenum |  Sinopen(um, i n
Sinopheninum |  Sinophenin(um, i n
Sintalgonum |  Sintalgon(um, i n
Sinthromum |  Sinthrom(um, i n
sinuatrialis |  sinuatrialis, e анат.
sinuatus |  sinuatus, a, um анат.
sinum |  sinum, i n
sinuo |  sinuo, avi, atum, are
sinuosus |  sinuosus, a, um
sinus |  sinus, us m
sinusoidis |  sinusoidis, is f
Siogenalum |  Siogenal(um, i n
Siogenonum |  Siogenon(um, i n
Siorenum |  Sioren(um, i n
Siosteranum |  Siosteran(um, i n
siparium |  siparium (siparum, supparum), i n
siphonarius |  siphonarius, i m
Siqualinum |  Siqualin(um, i n
Siqualonum |  Siqualon(um, i n
siquidem |  siquidem adv.
Siren |  Siren, enis f
Sirius |  Sirius, i m
sirp |  sirp...
sirupus |  sirupus, i m
siser |  siser, eris n
sisto |  sisto, stiti (steti), statum, ere
sistrum |  sistrum, i n
sisymbrium |  sisymbrium, i n
Sisyphos |  Sisyphos (-us), i m
sitella |  sitella, ae f
siticulosus |  siticulosus, a, um
sitiens |  sitiens, entis
sitio |  sitio, ivi (ii), itum, ire
sitis |  sitis, is f
situs |  I situs, a, um m
sive |  sive ( арх.
skeleton |  skeleton, i n
slmulate |  slmulate adv.
smaragdus |  smaragdus (zmaragdus), i m
smaris |  smaris (zmaris) idis f
smegma |  smegma, atis n
Smyrna |  Smyrna, ae f
sobol |  sobol...
sobrius |  sobrius, a, um
soccus |  soccus, i m
socer |  socer, eri m
socia |  socia, ae f
socialis |  socialis, e поэт.
socialiter |  socialiter adv.
societas |  societas, atis f
socio |  socio, avi, atum, are
socius |  I socius, a, um m
soclabilis |  soclabilis, e
socordia |  socordia (secordia), ae f
socorditer |  socorditer adv.
socors |  socors, ordis
Socrates |  Socrates, is acc.
socrus |  socrus, us f
sodalicium |  sodalicium, i n
sodalicius |  sodalicius, a, um
sodalis |  I sodalis, e m
sodalitas |  sodalitas, atis f
Sodantonum |  Sodanton(um, i n
sodes |  sodes
Sodium |  Sodium, i n
Sogdiana |  Sogdiana, ae f
sol |  sol, solis m
solacium |  solacium
solamen |  solamen, inis n
Solanthylum |  Solanthyl(um, i n
Solantoinum |  Solantoin(um, i n
Solantylum |  Solantyl(um, i n
Solapsonum |  Solapson(um, i n
solaris |  solaris, e
solarium |  solarium, i n
Solasulfonum |  Solasulfon(um, i n
solatium |  solatium (solacium), i n
Solcainum |  Solcain(um, i n
soldurii |  soldurii, orum m
soldus |  soldus, a, um
solea |  solea, ae f
soleatus |  soleatus, a, um
solemn |  solemn...
solenn |  solenn...
soleo |  soleo, solitus sum, ere
soler |  soler...
soleus |  soleus, a, um анат.
solido |  solido, avi, atum, are
solidum |  solidum, i n
solidus |  solidus, a, um
solistimum trlpudlum |  solistimum trlpudlum
solitarius |  solitarius, a, um анат.
solitudo |  solitudo, inis f
solitum |  solitum, i n
solitus |  solitus, a, um
solium |  solium, i n
sollemne |  sollemne, is n
sollemnis |  sollemnis (solemnis или solennis), e
sollemniter |  sollemniter (solemniter или solenniter) adv.
sollers |  sollers, ertis
sollerter |  sollerter adv.
sollertia |  sollertia, ae f
sollicitatio |  sollicitatio, onis f
sollicito |  sollicito, avi, atum, are поэт.
sollicitudo |  sollicitudo, inis f
sollicitus |  sollicitus, a, um pass.
solliferreum |  solliferreum (soliferreum), i n
sollus |  sollus, a, um арх.
Solon |  Solo(n), onis m
solor |  solor, atus sum, ari
Soloxinum |  Soloxin(um, i n
Solquinatum |  Solquinat(um, i n
solstitialis |  solstitialis, e
solstitium |  solstitium, i n
solubilis |  solubilis, e
Solufyllinum |  Solufyllin(um, i n
Soluglaucitum |  Soluglaucit(um, i n
solum |  I solum adv.
solus |  solus, a, um gen.
Solusulfonum |  Solusulfon(um, i n
Solusurminum |  Solusurmin(um, i n
Solutanum |  Solutan(um, i n
solute |  solute adv.
Soluthizonum |  Soluthizon(um, i n
solutio |  solutio, onis f
solutus |  solutus, a, um хим.
solvo |  solvo, solvi, solutum, ere pass.
soma |  soma, atis n
Somadrilum |  Somadril(um, i n
Somanilum |  Somanil(um, i n
somaticus |  somaticus, a, um анат.
somatogamia |  somatogamia, ae f
somatogenus |  somatogenus, a, um биолог.
Sombenum |  Somben(um, i n
Somberolum |  Somberol(um, i n
Sombrabilum |  Sombrabil(um, i n
Sombrevinum |  Sombrevin(um, i n
Somnalinum |  Somnalin(um, i n
Somnibromum |  Somnibrom(um, i n
somniculosus |  somniculosus, a, um
Somnidonum |  Somnidon(um, i n
Somnifer |  Somnifer, a, um фармац.
somnifer |  somnifer, era, erum поэт.
somnium |  somnium, i n
Somnokalanum |  Somnokalan(um, i n
Somnopanum |  Somnopan(um, i n
Somnopentylum |  Somnopentyl(um, i n
Somnotroponum |  Somnotropon(um, i n
Somnurolum |  Somnurol(um, i n
somnus |  somnus, i m
Somonalum |  Somonal(um, i n
Somponum |  Sompon(um, i n
sonabilis |  sonabilis, e
Sonalum |  Sonal(um, i n
sonans |  sonans, antis
Sonapaxum |  Sonapax(um, i n
Sonimenum |  Sonimen(um, i n
sonipes |  I sonipes, edis m
sonitus |  sonitus, us m
sono |  sono, sonui, sonitum, are поэт.
sonor |  sonor, oris m
sonorus |  sonorus, a, um
sons |  I sons, sontis m
sonus |  sonus, i m
Sopentalum |  Sopental(um, i n
Sophocles |  Sophocles, is m
Sophora |  Sophora, ae f
Sophoretinum |  Sophoretin(um, i n
Sophorinum |  Sophorin(um, i n
sopio |  sopio, ivi (ii), itum, ire
Sopolcortum |  Sopolcort(um, i n
sopor |  sopor, oris m
soporifer |  soporifer, era, erum
soporo |  soporo, avi, atum, are
soporus |  soporus, a, um
Sorbangilum |  Sorbangil(um, i n
sorbeo |  sorbeo, bui, (ptum), ere
sorbum |  sorbum, i n
sorbus |  sorbus, i f
sordeo |  sordeo, dui, --, ere
sordes |  sordes, is f
sordesco |  sordesco, --, --, ere
sordidatus |  sordidatus, a, um
sordidus |  sordidus, a, um
soror |  soror, oris f
sororicida |  sororicida, ae m
sororius |  sororius, a, um
Sorotum |  Sorot(um, i n
sors |  sors, sortis f
sortilegus |  sortilegus, a, um
sortior |  sortior, itus sum, iri
sortitio |  sortitio, onis f
sortito |  sortito adv.
sortitus |  I sortitus, a, um m
sospes |  sospes, itis поэт.
sospita |  sospita, ae f
sospito |  sospito, --, --, are
soter |  soter, eris m
Sovcainum |  Sovcain(um, i n
Sp. |  Sp.
spadix |  I spadix, icis m
spado |  spado, onis m
spargo |  spargo, sparsi, sparsum, ere pass.
Sparinum |  Sparin(um, i n
sparsus |  sparsus, a, um
Sparta |  Sparta, ae f
Spartacus |  Spartacus, i m
spartum |  spartum, i n
sparulus |  sparulus, i m
sparus |  sparus, i m
Spasmolytinum |  Spasmolytin(um, i n
Spasmophenum |  Spasmophen(um, i n
spasmophilia |  spasmophilia, ae f
Spasmoveralginum |  Spasmoveralgin(um, i n
spatior |  spatior, atus sum, ari
spatiose |  spatiose adv.
spatiosus |  spatiosus, a, um
spatium |  spatium, i n
species |  species, ei f
specillum |  specillum, i n
specimen |  specimen, inis n
speciose |  speciose adv.
speciosus |  speciosus, a, um
spectabilis |  spectabilis, e
spectaculum |  spectaculum, i n
spectatio |  spectatio, onis f
spectator |  spectator, oris m
spectatrix |  spectatrix, icis f
spectatus |  spectatus, a, um
spectio |  spectio, onis f
specto |  specto, avi, atum, are
specula |  I specula, ae f
speculator |  speculator, oris m
speculatorius |  speculatorius, a, um
speculor |  speculor, atus sum, ari
speculum |  speculum, i n
specus |  specus, us m
spelaeum |  spelaeum, i n
spelunca |  spelunca, ae f
sperma |  sperma, atis n
spermaticus |  spermaticus, a, um анат.
spermatoblastum |  spermatoblast(um, i n
spermatogenesis |  spermatogenesis, is f
spermatogenus |  spermatogenus, a, um биолог.
spermatogonium |  spermatogonium, i n
spermatovum |  spermatovum, i n
spermium |  spermium, i n
sperno |  sperno, sprevi, spretum, ere
spero |  spero, avi, atum, are
spes |  spes, ei f
sphenoethmoidalis |  sphenoethmoidalis, e анат.
sphenoidalis |  sphenoidalis, e анат.
sphenomandibularis |  sphenomandibularis, e анат.
sphenomaxillaris |  sphenomaxillaris, e анат.
sphenopalatinus |  sphenopalatinus, a, um анат.
sphenoparietalis |  sphenoparietalis, e анат.
sphenopetrosus |  sphenopetrosus, a, um анат.
sphericus |  sphericus, a, um
spheroides |  spheroides, is анат.
spheroideus |  spheroideus, a, um
Spheromycinum |  Spheromycin(um, i n
sphincter |  sphincter, tris m
Sphinx |  Sphinx, Sphingis f
spica |  spica, ae f
spiceus |  spiceus, a, um
spiciformis |  spiciformis, e биолог.
spicium |  spicium, i n
spicula |  spicula, ae f
spiculator |  spiculator, oris m
spiculum |  spiculum, i n
spicum |  spicum, i n
spina |  spina, ae f
spinalis |  spinalis, e анат.
spinetum |  spinetum, i n
spineus |  spineus, a, um
spinicaudatus |  spinicaudatus, a, um биолог.
spiniformis |  spiniformis, e биолог.
spiniger |  spiniger, era, erum
spinocerebellaris |  spinocerebellaris, e анат.
spinosus |  I spinosus, a, um анат.
spinotectalis |  spinotectalis, e
spinothalamicus |  spinothalamicus, a, um анат.
spinula |  spinula, ae f
spinus |  spinus, i f
spira |  spira, ae f
spirabilis |  spirabilis, e поэт.
spiraculum |  spiraculum, i n
spiralis |  spiralis, e
spiramentum |  spiramentum, i n
Spiramycinum |  Spiramycin(um, i n
Spirazidinum |  Spirazidin(um, i n
spiritus |  spiritus, us m
spiro |  spiro, avi, atum, are поэт.
Spirocidum |  Spirocid(um, i n
Spironolactonum |  Spironolacton(um, i n
Spironovanum |  Spironovan(um, i n
spisso |  spisso, avi, atum, are
spissus |  spissus, a, um
splanchnicus |  splanchnicus, a, um анат.
splanchnocranium |  splanchnocranium, i n
splanclinologia |  splanclinologia, ae f
splen |  splen, splenis m
splendeo |  splendeo, --, --, ere
splendesco |  splendesco, dui, --, ere
splendide |  splendide adv.
splendidus |  splendidus, a, um
splendor |  splendor, oris m
splenectomia |  splenectomia, ae f
Spleninum |  Splenin(um, i n
splenium |  splenium, i n
splenius |  splenius, a, um анат.
splenomegalia |  splenomegalia, ae f
splenoptosis |  splenoptosis, is f
splenorenalis |  splenorenalis, e мед.
Spofadazinum |  Spofadazin(um, i n
spoliatio |  spoliatio, onis f
spoliator |  spoliator, oris m
spoliatrix |  I spoliatrix, icis f
spolio |  spolio, avi, atum, are
spolium |  spolium, i n
sponda |  sponda, ae f
spondeo |  spondeo, spopondi, sponsum, ere
spondeus |  spondeus (spondius), i m
spondius |  spondius, i m
spondylitis |  spondylitis, idis f
spondyloarthritis |  spondyloarthritis, idis f
spondylopathia |  spondylopathia, ae f
spondylos |  spondylos, i m
spondylosis |  spondylosis, is f
spongea |  spongea, ae f
spongia |  spongia (spongea), ae f
spongiosus |  spongiosus, a, um анат.
sponsa |  sponsa, ae f
sponsalia |  sponsalia, ium (orum) n
sponsalis |  sponsalis, e
sponsio |  sponsio, onis f
sponsor |  sponsor, oris m
sponsum |  sponsum, i n
sponsus |  sponsus, i m
sponte |  sponte abl.
sporangium |  sporangium, i n
sporoderma |  sporoderma, atis n
sporogenus |  sporogenus, a, um биолог.
sporogonia |  sporogonia, ae f
sporta |  sporta, ae f
Spredinum |  Spredin(um, i n
spretor |  spretor, oris m
spuma |  spuma, ae f
spumesco |  spumesco, --, --, ere
spumeus |  spumeus, a, um
spumifer |  spumifer, era, erum
spumo |  spumo, avi, atum, are поэт.
spumosus |  spumosus, a, um
spuo |  spuo, ui, --, ere
spurce |  spurce adv.
spurco |  spurco, avi, atum, are
spurcus |  spurcus, a, um
spuria |  spuria, ae f
spurius |  I spurius, a, um анат.
sputo |  sputo, avi, atum, are
sputum |  sputum, i n
squaleo |  squaleo, --, --, ere
squalidus |  squalidus, a, um
squalor |  squalor, oris m
squalus |  squalus, i m
squama |  squama, ae f
squameus |  squameus, a, um
squamiformis |  squamiformis, e биолог.
squamiger |  squamiger, era, erum
squamosus |  squamosus, a, um
squilla |  squilla, ae f
Stabicillinum |  Stabicillin(um, i n
stabilio |  stabilio, ivi, itum, ire
stabilis |  stabilis, e
stabilitas |  stabilitas, atis f
stabulo |  stabulo, --, --, are
stabulor |  stabulor, atus sum, ari
stabulum |  I stabulum, i n
stachyphorus |  stachyphorus, a, um биолог.
stadium |  stadium, i n
Stafylopentinum |  Stafylopentin(um, i n
Stagira |  Stagira, orum n
stagno |  stagno, avi, atum, are
stagnum |  stagnum, i n
stamen |  stamen, inis n
Stamicinum |  Stamicin(um, i n
stapedius |  stapedius, a, um анат.
Stapenorum |  Stapenor(um, i n
stapes |  stapes, edis m
Staphylococcus |  Staphylococcus, i m
Staphylomycinum |  Staphylomycin(um, i n
statarius |  statarius, a, um
staticus |  staticus, a, um анат.
statim |  statim adv.
statio |  I statio, onis f
stativa |  stativa, orum n
stativus |  stativus, a, um
statoacusticus |  statoacusticus, a, um анат.
statoconia |  statoconia, ae f
stator |  I stator, oris m
statua |  statua, ae f
statuo |  statuo, tui, tutum, ere
statura |  statura, ae f
status |  status, us m
Stazepinum |  Stazepin(um, i n
Steclinum |  Steclin(um, i n
Stelazinum |  Stelazin(um, i n
steliatus |  steliatus, a, um анат.
stelio |  stelio
stella |  stella, ae f
stellans |  stellans, antis поэт.
stellatus |  stellatus, a, um поэт.
Stellidinum |  Stellidin(um, i n
stellio |  stellio (stelio), onis m
stellula |  stellula, ae f
Stemetilum |  Stemetil(um, i n
Stenandiolum |  Stenandiol(um, i n
Stenediolum |  Stenediol(um, i n
stenocardia |  stenocardia, ae f
Stenocardilum |  Stenocardil(um, i n
stenocarpus |  stenocarpus, a, um биолог.
Stenolonum |  Stenolon(um, i n
stenosis |  stenosis, is f
Sterandrylum |  Sterandryl(um, i n
Steranum |  Steran(um, i n
Sterculia |  Sterculia, ae f
stercus |  stercus, oris n
stereoroentgenographia |  stereoroentgenographia, ae f
sterilis |  sterilis, e поэт.
sterilisatus |  sterilisatus, a, um фармац.
sterilitas |  sterilitas, atis f
sternalis |  sternalis, e анат.
sternax |  sternax, acis
sterno |  sterno, stravi, stratum, ere
sternocleidomastoideus |  sternocleidomastoideus, a, um анат.
sternocostalis |  sternocostalis, e анат.
sternoctavicularis |  sternoctavicularis, e анат.
sternohyoideus |  sternohyoideus, a, um анат.
sternopericardiacus |  sternopericardiacus, a, um анат.
sternothyroideus |  sternothyroideus, a, um анат.
sternoxiphoideus |  sternoxiphoideus, a, um анат.
sternum |  sternum, i n
sternumentum |  sternumentum, i n
sternuo |  sternuo, ui, --, ere поэт.
Sterosanum |  Sterosan(um, i n
Steroxinum |  Steroxin(um, i n
sterto |  sterto, tui, --, ere
Stibnalum |  Stibnal(um, i n
Stibyalum |  Stibyal(um, i n
Stickoxydalum |  Stickoxydal(um, i n
stigma |  stigma, atis n
Stigmosanum |  Stigmosan(um, i n
Stilbarolum |  Stilbarol(um, i n
Stilbestrolum |  Stilbestrol(um, i n
Stilbestronatum |  Stilbestronat(um, i n
Stilbetinum |  Stilbetin(um, i n
Stilboestroformum |  Stilboestroform(um, i n
Stilboestronum |  Stilboestron(um, i n
Stilbofollinum |  Stilbofollin(um, i n
Stilboralum |  Stilboral(um, i n
stillo |  stillo, avi, atum, are
Stilphostrolum |  Stilphostrol(um, i n
Stilus |  Stilus pl.
stilus |  stilus, i m
stimulo |  stimulo, avi, atum, are
Stimulolum |  Stimulol(um, i n
stimulus |  stimulus, i m
stinguo |  stinguo, --, --, ere pass.
stipatio |  stipatio, onis f
stipator |  stipator, oris m
stipendiarius |  I stipendiarius, a, um m
stipendium |  stipendium, i n
stipes |  stipes, itis m
stipo |  stipo, avi, atum, are
stips |  stips, stipis f
stipula |  stipula, ae f
stipulatio |  stipulatio, onis f
stipulor |  stipulor, atus sum, ari
stiria |  stiria, ae f
stirps |  stirps, stirpis f
stiva |  stiva, ae f
sto |  sto, steti, statum, are воен.
Stoechados |  Stoechados, i m
stola |  stola, ae f
stolide |  stolide adv.
stolidus |  stolidus, a, um
stoma |  stoma, atis n
stomachor |  stomachor, atus sum, ari
stomachosus |  stomachosus, a, um
stomachus |  stomachus, i m
stomatitis |  stomatitis, idis f
stomatologia |  stomatologia, ae f
stomatologus |  stomatologus, i m
stomatorrhagia |  stomatorrhagia, ae f
stomatoscopia |  stomatoscopia, ae f
Stopethylum |  Stopethyl(um, i n
storea |  storea (storia), ae f
Stovarsolum |  Stovarsol(um, i n
Stoxilum |  Stoxil(um, i n
strabo |  strabo, onis m
strages |  strages, is f
stragulum |  stragulum, i n
stragulus |  stragulus, a, um
stramen |  stramen, inis n
stramenticius |  stramenticius, a, um
stramentum |  stramentum, i n
stramineus |  stramineus, a, um
strangulo |  strangulo, avi, atum, are
stranguria |  stranguria, ae f
stratum |  stratum, i n
strenue |  strenue adv.
strenuitas |  strenuitas, atis f
strenuus |  strenuus, a, um
strepito |  strepito, --, --, are
strepitus |  strepitus, us m
strepo |  strepo, pui, pitum, ere поэт.
Strepolinum |  Strepolin(um, i n
Strepsulfatum |  Strepsulfat(um, i n
Streptaminum |  Streptamin(um, i n
Streptaquainum |  Streptaquain(um, i n
Streptasum |  Streptas(um, i n
Streptocidum |  Streptocid(um, i n
Streptocillinum |  Streptocillin(um, i n
Streptococcus |  Streptococcus, i m
Streptodimycinum |  Streptodimycin(um, i n
Streptomycinum |  Streptomycin(um, i n
Streptonigrinum |  Streptonigrin(um, i n
Streptonivicinum |  Streptonivicin(um, i n
Streptosaluzidum |  Streptosaluzid(um, i n
Streptozolum |  Streptozol(um, i n
stria |  stria, ae f
Striadynum |  Striadyn(um, i n
Strialginum |  Strialgin(um, i n
striaticus |  striaticus, a, um анат.
striatum |  striatum, i n
striatus |  striatus, a, um анат.
strictim |  strictim adv.
strictura |  I strictura, ae f
strictus |  strictus, a, um
strideo |  strideo, stridi, --, ere
strido |  strido, stridi, --, ere
stridor |  stridor, oris m
stridulus |  stridulus, a, um
strigilis |  strigilis, is f
strigosus |  strigosus, a, um
stringo |  stringo, strinxi, strictum, ere поэт.
strix |  strix, strigis f
stroma |  stroma, atis n
Strophanthinum |  Strophanthin(um, i n
Strophanthus |  Strophanthus, i m
Strophicorum |  Strophicor(um, i n
strophium |  strophium, i n
Strophosanum |  Strophosan(um, i n
structura |  structura, ae f
strues |  strues, is f
struma |  struma, ae f
Strumacilum |  Strumacil(um, i n
strumectomia |  strumectomia, ae f
strumitis |  strumitis, idis f
struo |  struo, struxi, structum, ere
Strycinum |  Strycin(um, i n
Strysolinum |  Strysolin(um, i n
studeo |  studeo, ui, --, ere
studiose |  studiose adv.
studiosus |  studiosus, a, um
studium |  studium, i n
stulte |  stulte adv.
stultitia |  stultitia, ae f
stultus |  I stultus, a, um m
stupa |  stupa
stupefacio |  stupefacio, feci, factum, ere
stupefactus |  stupefactus, a, um
stupefio |  stupefio, factus sum, fieri pass.
stupeo |  stupeo, pui, --, ere
stupesco |  stupesco, --, --, ere
stupeus |  stupeus, a, um
stupiditas |  stupiditas, atis f
stupidus |  stupidus, a, um
stupor |  stupor, oris m
stuppa |  stuppa (stupa), ae f
stuppeus |  stuppeus (stupeus), a, um
stupro |  stupro, avi, atum, --, --, are
stuprum |  stuprum, i n
styloglossus |  styloglossus, a, um анат.
stylohyoideus |  stylohyoideus, a, um анат.
styloides |  styloides, is анат.
styloideus |  styloideus, a, um
stylomandibularis |  stylomandibularis, e анат.
stylomastoideus |  stylomastoideus, a, um анат.
stylopharyngeus |  stylopharyngeus, a, um анат.
stylus |  I stylus, i m
Stypticinum |  Stypticin(um, i n
Styptirenalum |  Styptirenal(um, i n
Styptogenum |  Styptogen(um, i n
styrax |  styrax, acis m
Styx |  Styx, Stygis (Stygos) f
sua |  sua, orum n
Suada |  Suada, ae f
suadeo |  suadeo, suasi, suasum, ere поэт.
suasio |  suasio, onis f
suasor |  suasor, oris m
suavior |  suavior
suavis |  suavis, e
suavitas |  suavitas, atis f
suaviter |  suaviter adv.
Suavitilum |  Suavitil(um, i n
suavium |  suavium
sub |  sub praep.
subaccuso |  subaccuso, --, --, are
subacromialis |  subacromialis, e анат.
subacutus |  subacutus, a, um анат.
subalaris |  subalaris, e
subapicalis |  subapicalis, e анат.
subaquosus |  subaquosus, a, um биолог.
subarachnoidealis |  subarachnoidealis, e анат.
subarcuatus |  subarcuatus, a, um анат.
subcenturio |  subcenturio, onis m
subchondralis |  subchondralis, e анат.
subcinctus |  subcinctus, a, um
subcingo |  subcingo
subcisivus |  subcisivus, a, um
subclavius |  subclavius, a, um анат.
subconjunctivalis |  subconjunctivalis, e анат.
subcorticalis |  subcorticalis, e анат.
subcostalis |  subcostalis, e анат.
subcresco |  subcresco
subcrispus |  subcrispus, a, um
subcruentus |  subcruentus, a, um
subcumbo |  subcumbo
subcutaneus |  subcutaneus, a, um анат.
subcutis |  subcutis, is f
subdeltoideus |  subdeltoideus, a, um анат.
subdiaphragmaticus |  subdiaphragmaticus, a, um анат.
subdifficilis |  subdifficilis, e
subditivus |  subditivus, a, um
subdo |  subdo, didi, ditum, ere
subdole |  subdole adv.
subdolus |  subdolus, a, um
subduco |  subduco, duxi, ductum, ere
subductio |  subductio, onis f
subduralis |  subduralis, e анат.
Subecholinum |  Subecholin(um, i n
subedo |  subedo, edi, --, ere
subehordalis |  subehordalis, e анат.
subeo |  subeo, ii, itum, ire
suber |  suber, eris n
subf |  subf...
subfascialis |  subfascialis, e анат.
subg |  subg...
subhepaticus |  subhepaticus, a, um анат.
subhorridus |  subhorridus, a, um
subicio |  subicio
subiculum |  subiculum, i n
subigo |  subigo, egi, actum, ere
subinde |  subinde adv.
subinguinalis |  subinguinalis, e анат.
subinvisus |  subinvisus, a, um
subirascor |  subirascor, --, irasci
subiratus |  subiratus, a, um
subita |  subita, orum n
subitarius |  subitarius, a, um
subito |  subito adv.
subitus |  subitus, a, um
subjecte |  subjecte adv.
subjectio |  subjectio, onis f
subjecto |  subjecto, --, --, are
subjector |  subjector, oris m
subjectus |  subjectus, a, um
subjicio |  subjicio (subicio), jeci, jectum, ere
subjungo |  subjungo, junxi, junctum, ere
sublabor |  sublabor, lapsus sum, labi
sublate |  sublate adv.
sublatus |  I sublatus, a, um part.
sublego |  sublego, legi, lectum, ere
sublentiformis |  sublentiformis, e
sublevo |  sublevo, avi, atum, are
sublica |  sublica, ae f
sublices |  sublices, um f
sublicius |  sublicius, a, um
subligar |  subligar, aris n
subligo |  subligo, avi, atum, are
Sublimatum |  Sublimat(um, i n
Sublimazum |  Sublimaz(um, i n
sublime |  sublime adv.
sublimis |  sublimis, e
sublimiter |  sublimiter adv.
sublimus |  sublimus, a, um
sublingualis |  sublingualis, e анат.
subluceo |  subluceo, luxi, --, ere
subluo |  subluo, --, --, ere
sublustris |  sublustris, e
submandibularis |  submandibularis, e анат.
submaxiliaris |  submaxiliaris, e анат.
submentalis |  submentalis, e анат.
submergo |  submergo (summergo), mersi, mercum, ere pass.
subministro |  subministro, avi, atum, are
submisse |  submisse (summisse) adv.
submissus |  submissus (summissus), a, um
submitto |  submitto (summitto), misi, missum, ere
submoveo |  submoveo (summoveo), movi, motum, ere
submucosus |  submucosus, a, um анат.
submuscularis |  submuscularis, e анат.
subnascor |  subnascor, natus sum, nasci
subnecto |  subnecto, nexui, nexum, ere
subnitras |  subnitras, atis m
subnixus |  subnixus (subnisus), a, um
subnuba |  subnuba, ae f
subnubilus |  subnubilus, a, um
subo |  subo, --, --, are
suboccipitalis |  suboccipitalis, e анат.
suboles |  suboles, is f
subolesco |  subolesco, --, --, ere
subordo |  subordo, inis m
suborno |  suborno, avi, atum, are
subp |  subp...
subpatellaris |  subpatellaris, e анат.
subperitonealis |  subperitonealis, e
subphrenicus |  subphrenicus, a, um анат.
subpopliteus |  subpopliteus, a, um анат.
subrancidus |  subrancidus, a, um
subrectus |  subrectus (surrectus), a, um part.
subremigo |  subremigo, --, --, are
subrepo |  subrepo, repsi, reptum, ere
subrideo |  subrideo, risi, risum, ere
subrigo |  subrigo (surrigo, surgo), surrexi, surrectum, ere
subripio |  subripio
subrogo |  subrogo, avi, atum, are
subrubeo |  subrubeo, --, --, ere
subruo |  subruo, rui, rutum, ere
subscapularis |  subscapularis, e анат.
subscleralis |  subscleralis, e анат.
subscribo |  subscribo, scripsi, scriptum, ere
subscriptio |  subscriptio, onis f
subscriptor |  subscriptor, oris m
subsecivus |  subsecivus
subseco |  subseco, secui, sectum, are
subsellium |  subsellium, i n
subsequor |  subsequor, secutus (sequutus) sum, sequi
subserosus |  subserosus, a, um анат.
subsicivus |  subsicivus, a, um
subsidiarii |  subsidiarii, orum m
subsidiarius |  subsidiarius, a, um
subsidior |  subsidior, --, ari
subsidium |  subsidium, i n
subsido |  subsido, sedi, sessum, ere
subsigno |  subsigno, avi, atum, are
subsisto |  subsisto, stiti, --, ere
subsortior |  subsortior, itus sum, iri
subsortitio |  subsortitio, onis f
substantia |  substantia, ae f
substerno |  substerno, stravi, stratum, ere
substituo |  substituo, tui, tutum, ere
substitutio |  substitutio, onis f
substrictus |  substrictus, a, um
substringo |  substringo, strinxi, strictum, ere
substructio |  substructio, onis f
substruo |  substruo, struxi, structum, ere
subsum |  subsum, fui, --, esse
subsuo |  subsuo, --, sutum, ere
subsuperior |  subsuperior, ius
subtalaris |  subtalaris, e анат.
subtemen |  subtemen (subtegmen), inis n
subtendineus |  subtendineus, a, um анат.
subter |  I subter adv.
subterfugio |  subterfugio, fugi, --, ere
subterlabor |  subterlabor, lapsus sum, labi
subterraneus |  subterraneus, a, um
subtexo |  subtexo, texui, textum, ere
subthalamicus |  subthalamicus, a, um анат.
subtilis |  subtilis, e
subtilitas |  subtilitas, atis f
subtiliter |  subtiliter adv.
subtimeo |  subtimeo, --, --, ere
subtraho |  subtraho, traxi, tractum, ere pass.
subtus |  subtus adv.
subucula |  subucula, ae f
subula |  subula, ae f
subulcus |  subulcus, i m
suburbani |  suburbani, orum m
suburbanitas |  suburbanitas, atis f
suburbanum |  suburbanum, i n
suburbanus |  suburbanus, a, um
suburbium |  suburbium, i n
suburgueo |  suburgueo, --, --, ere
subvectio |  subvectio, onis f
subvecto |  subvecto, --, --, are
subveho |  subveho, vexi, vectum, ere pass.
subvenio |  subvenio, veni, ventum, ire
subverto |  subverto (subvorto), verti (vorti), versum (vorsum), ere
subvexus |  subvexus, a, um
subvolo |  subvolo, --, --, are
subvolvo |  subvolvo, --, --, ere
succedo |  succedo, cessi, cessum, ere воен.
succendo |  succendo, cendi, censum, ere
succenseo |  succenseo, censui, censum, ere
succenturiatus |  succenturiatus, a, um анат.
succenturio |  succenturio, onis m
successio |  successio, onis f
successor |  successor, oris m
successus |  successus, us m
succido |  I succido, cidi, --, ere
succiduus |  succiduus, a, um
Succimalum |  Succimal(um, i n
succinctus |  I succinctus, a, um
succingo |  succingo, cinxi, cinctum, ere
succino |  succino, --, --, ere
succisivus |  succisivus, a, um
succlamatio |  succlamatio, onis f
succlamo |  succlamo (subclamo), avi, atum, are преим.
succresco |  succresco (subcresco), crevi, cretum, ere
Succudiferum |  Succudifer(um, i n
succumbo |  succumbo, cubni, cubitum, ere
succurro |  succurro, curri, cursum, ere
succus |  I succus, i m
succutio |  succutio, cussi, cussum, ere
Sucostrinum |  Sucostrin(um, i n
Sucradbellum |  Sucradbell(um, i n
suculentum |  suculentum, i n
sucus |  sucus (succus), i m
sudis |  sudis, is f
sudo |  sudo, avi, atum, are
sudor |  sudor, oris m
sudorifer |  sudorifer, erа, erum
sudum |  sudum, i n
sudus |  sudus, a, um
Suebi |  Suebi, orum m
suesco |  suesco, suevi, suetum, ere
Suetonius |  Suetonius, a, um
suetus |  suetus, a, um
sufes |  sufes (suffes), etis m
suffero |  suffero, --, --, sufferre
suffes |  suffes
sufficio |  sufficio, feci, fectum, ere
suffigo |  suffigo, fixi, fixum, ere
suffimen |  suffimen, inis n
suffimentum |  suffimentum, i n
suffio |  suffio, ivi (ii), itum, ire
suffoco |  suffoco, avi, atum, are
suffodio |  suffodio, fodi, fossum, ere
suffragatio |  suffragatio, onis f
suffragator |  suffragator, oris m
suffragium |  suffragium, i n
suffragor |  suffragor, atus sum, ari
suffringo |  suffringo, --, --, ere
suffugio |  suffugio, fugi, fugitum, ere
suffugium |  suffugium, i n
suffundo |  suffundo, fudi, fusum, ere pass.
Sugambri |  Sugambri (Sygambri), orum m
suggero |  suggero, gessi, gestum, ere
suggestum |  suggestum, i n
suggill |  suggill...
suggredior |  suggredior, gressus sum, gredi
sugillatio |  sugillatio, onis f
sugillo |  sugillo, avi, atum, are
sugo |  sugo, suxi, suctum, ere
sui |  I sui gen.
Suifadurazinum |  Suifadurazin(um, i n
Suifarsphenaminum |  Suifarsphenamin(um, i n
suillus |  I suillus, a, um
sulco |  sulco, avi, atum, are поэт.
sulcus |  sulcus, i m
Sulfacarbamidum |  Sulfacarbamid(um, i n
Sulfadazina |  Sulfadazina, ae f
Sulfademidinum |  Sulfademidin(um, i n
Sulfadiazinum |  Sulfadiazin(um, i n
Sulfadiezinum |  Sulfadiezin(um, i n
Sulfadimerazinum |  Sulfadimerazin(um, i n
Sulfadimezinum |  Sulfadimezinum, i n
Sulfadimidinum |  Sulfadimidin(um, i n
Sulfadiniezinum |  Sulfadiniezin(um, i n
Sulfadiurinum |  Sulfadiurin(um, i n
Sulfaguanidinum |  Sulfaguanidin(um, i n
Sulfalenum |  Sulfalen(um, i n
Sulfamethazinum |  Sulfamethazin(um, i n
Sulfamethopyrazinum |  Sulfamethopyrazin(um, i n
Sulfamethoxypyrazinum |  Sulfamethoxypyrazin(um, i n
Sulfamethoxypyridazinum |  Sulfamethoxypyridazin(um, i n
Sulfamethylpyrimidinum |  Sulfamethylpyrimidin(um, i n
Sulfametopyrazinum |  Sulfametopyrazin(um, i n
Sulfamezatilum |  Sulfamezatil(um, i n
Sulfamezatinum |  Sulfamezatin(um, i n
Sulfamidylum |  Sulfamidyl(um, i n
Sulfamilonum |  Sulfamilon(um, i n
Sulfamonomethoxinum |  Sulfamonomethoxin(um, i n
Sulfanilamidum |  Sulfanilamid(um, i n
Sulfapyrazinmethoxinum |  Sulfapyrazinmethoxin(um, i n
Sulfapyridazinum |  Sulfapyridazin(um, i n
Sulfapyrimidinum |  Sulfapyrimidin(um, i n
Sulfarsenolum |  Sulfarsenol(um, i n
sulfas |  sulfas, atis m
Sulfasalazinum |  Sulfasalazin(um, i n
Sulfastopum |  Sulfastop(um, i n
Sulfathalidinum |  Sulfathalidin(um, i n
Sulfaurea |  Sulfaurea, ae f
Sulfavaginum |  Sulfavagin(um, i n
Sulfazinum |  Sulfazin(um, i n
Sulfazolum |  Sulfazol(um, i n
Sulfetronum |  Sulfetron(um, i n
sulfidum |  sulfidum, i n
Sulfinpyrazonum |  Sulfinpyrazon(um, i n
sulfis |  sulfis, itis m
Sulfodemezinum |  Sulfodemezin(um, i n
Sulfodiaminum |  Sulfodiamin(um, i n
Sulfonilcarbamidum |  Sulfonilcarbamid(um, i n
Sulfoninum |  Sulfonin(um, i n
Sulfonmerum |  Sulfonmer(um, i n
Sulfostabum |  Sulfostab(um, i n
Sulfozinum |  Sulfozin(um, i n
sulfur |  sulfur (sulphur, sulpur), uris n
Sulfurenum |  Sulfuren(um, i n
sulfureus |  sulfureus, a, um
sulfuricus |  sulfuricus, a, um хим.
Sulginum |  Sulgin(um, i n
Sulla |  Sulla, ae m
sullferreum |  sullferreum, i n
Sulmetum |  Sulmet(um, i n
Sulphadimetilylpyrimidinum |  Sulphadimetilylpyrimidin(um, i n
Sulphadimidinum |  Sulphadimidin(um, i n
Sulphaguanidinum |  Sulphaguanidin(um, i n
Sulphamethoxypyridazinum |  Sulphamethoxypyridazin(um, i n
Sulphasalazinum |  Sulphasalazin(um, i n
Sulphathiazolum |  Sulphathiazol(um, i n
Sulphedronum |  Sulphedron(um, i n
Sulphonazinum |  Sulphonazin(um, i n
Sulpyrinum |  Sulpyrin(um, i n
Sulsenum |  Sulsen(um, i n
sultis |  sultis см.
Sulxinum |  Sulxin(um, i n
sum |  sum, fui, --, esse
Sumialum |  Sumial(um, i n
summa |  summa, ae f
summatim |  summatim adv.
summergo |  summergo
sumministro |  sumministro
summitto |  summitto
summoveo |  summoveo
summum |  I summum adv.
summus |  I summus, a, um superl.
sumo |  sumo, sumpsi, sumptum, ere
sumptuarius |  sumptuarius, a, um
sumptuose |  sumptuose adv.
sumptuosus |  sumptuosus, a, um
sumptus |  sumptus, us m
Sunorephum |  Sunoreph(um, i n
Sunoxolum |  Sunoxol(um, i n
suo |  suo, sui, sutum, ere
suovetaurilia |  suovetaurilia (suovitaurilia), ium n
supellectilis |  supellectilis, is f
supellex |  supellex, ectilis f
super |  I super adv.
supera |  supera adv.
superabilis |  superabilis, e
superaddo |  superaddo, addidi, additum, ere
Superanabolonum |  Superanabolon(um, i n
superasto |  superasto (superadsto), --, --, are
superator |  superator, oris m
superbe |  superbe adv.
superbia |  superbia, ae f
superbio |  superbio, --, --, ire
superbus |  superbus, a, um поэт.
superciliaris |  superciliaris, e анат.
supercilium |  supercilium, i n
superclassis |  superclassis, is f
Supercortum |  Supercort(um, i n
superemineo |  superemineo, --, --, ere
superficialis |  superficialis, e анат.
superficies |  superficies, ei f
superfigo |  superfigo, fixus, --, ere
superfundo |  superfundo, fudi, fusum, ere pass.
superi |  superi, orum (um) m
superimmineo |  superimmineo, --, --, ere
superimpono |  superimpono, (posui), positum, ere
superincido |  superincido, --, --, ere
superincumbo |  superincumbo, cubui, --, ere
superinjicio |  superinjicio, jeci, jectum, ere
superinl |  superinl...
superinm |  superinm...
superinp |  superinp...
superinsterno |  superinsterno, stravi, --, ere
superior |  superior, ius compar.
superiores |  superiores, um m
superjacio |  superjacio, jeci, jectum (jactum), ere pass.
superne |  superne adv.
supernus |  supernus, a, um
supero |  supero, avi, atum, are воен.
superoccupo |  superoccupo, --, --, are
superolateralis |  superolateralis, e анат.
Superolum |  Superol(um, i n
superomedialis |  superomedialis, e анат.
superpendens |  superpendens, entis
superpono |  superpono, posui, positum, ere
Superprendolum |  Superprendol(um, i n
superscando |  superscando (scendo), --, --, ere
supersedeo |  supersedeo, sedi, sessum, ere
Superseptilum |  Superseptil(um, i n
supersterno |  supersterno, (stravi), stratum, ere
superstes |  superstes, itis
superstitio |  superstitio, onis f
superstitiose |  superstitiose adv.
superstitiosus |  superstitiosus, a, um
supersto |  supersto, steti, --, are
Supersulfa |  Supersulfa, ae f
supersum |  supersum, fui, --, esse поэт.
superus |  superus, a, um compar.
supervacaneus |  supervacaneus, a, um
supervacuus |  supervacuus, a, um
supervado |  supervado, --, --, ere
supervehor |  supervehor, vectus sum, vehi
supervenio |  supervenio, veni, ventum, ire поэт.
supervolito |  supervolito, avi, --, are
supervolo |  supervolo, --, --, are
supinatio |  supinatio, onis f
supinator |  supinator, aris m
supino |  supino, avi, atum, are
supinus |  I supinus, a, um поэт.
suppaenitet |  suppaenitet (suppoenitet), --, --, ere impers.
supparum |  supparum, i n
suppedito |  suppedito, avi, atum, are
suppetiae |  suppetiae, arum f
suppeto |  suppeto, ivi (ii), itum, ere
supplanto |  supplanto, avi, atum, are
supplementum |  supplementum, i n
suppleo |  suppleo, plevi, pletum, ere воен.
supplex |  supplex, icis
supplicatio |  supplicatio, onis f
suppliciter |  suppliciter adv.
supplicium |  supplicium, i, n.
supplico |  supplico, avi, atum, are
supplodo |  supplodo, plosi, plosum, ere
supplosio |  supplosio, onis f
suppono |  suppono, posui, positum, ere
supporto |  supporto, avi, atum, are
suppositus |  suppositus, a, um
suppostus |  suppostus, a, um part.
suppressio |  suppressio, onis f
suppressus |  suppressus, a, um
supprimo |  supprimo, pressi, pressum, ere
supputo |  supputo, --, --, are
supra |  I supra adv.
supraacromialis |  supraacromialis, e анат.
suprachorioideus |  suprachorioideus, a, um анат.
supraclavicularis |  supraclavicularis, e анат.
supracondyloideus |  supracondyloideus, a, um анат.
supradiapliragmaticus |  supradiapliragmaticus, a, um анат.
supraduodenalis |  supraduodenalis, e анат.
supraglenoidalis |  supraglenoidalis, e анат.
suprahyoideus |  suprahyoideus, a, um анат.
suprainguinalis |  suprainguinalis, e анат.
supramalleolaris |  supramalleolaris, e
supramarginalis |  supramarginalis, e анат.
supramastoidalis |  supramastoidalis, e анат.
supramaxillaris |  supramaxillaris, e анат.
supranavicularis |  supranavicularis, e анат.
supranuclearis |  supranuclearis, e анат.
supraopticus |  supraopticus, a, um анат.
supraorbitalis |  supraorbitalis, e анат.
suprapatellaris |  suprapatellaris, e анат.
suprapinealis |  suprapinealis, e анат.
suprapiriformis |  suprapiriformis, e
suprapleuralis |  suprapleuralis, e анат.
suprapubicus |  suprapubicus, а, um
suprarenalis |  suprarenalis, e анат.
suprascapularis |  suprascapularis, e анат.
suprascaudo |  suprascaudo, --, --, ere
supraspinalis |  supraspinalis, e анат.
supraspinatus |  supraspinatus, a, um анат.
suprasternalis |  suprasternalis, e анат.
supratalaris |  supratalaris, e анат.
supratonsillaris |  supratonsillaris, e анат.
supratrochlearis |  supratrochlearis, e анат.
supravaginalis |  supravaginalis, e анат.
supraventricularis |  supraventricularis, e анат.
supravesicalis |  supravesicalis, e анат.
suprema |  suprema, orum n
supremum |  supremum adv.
supremus |  supremus, a, um superl.
sura |  sura, ae f
suralis |  suralis, e анат.
surculus |  surculus, i m
surdomutus |  surdomutus, a, um совр.
surdus |  surdus, a, um поэт.
surgo |  surgo
surrepo |  surrepo
surrigo |  surrigo
surripio |  surripio, ripui, reptum, ere pass.
surrogo |  surrogo
sursum |  sursum adv.
sus |  sus, suis m
Susa |  Susa, orum n
susceptio |  susceptio, onis f
suscipio |  suscipio, cepi, ceptum, ere
suscito |  suscito, avi, atum, are
suspectus |  I suspectus, a, um m
suspendium |  suspendium, i n
suspendo |  suspendo, pendi, pensum, ere
suspensorius |  suspensorius, a, um анат.
suspensus |  I suspensus, a, um
suspicax |  suspicax, acis
suspicio |  I suspicio, spexi, spectum, ere f
suspiciose |  suspiciose adv.
suspiciosus |  suspiciosus, a, um
suspicor |  suspicor, atus sum, ari
suspiratus |  suspiratus, us m
suspiritus |  suspiritus, us m
suspirium |  suspirium, i n
suspiro |  suspiro, avi, atum, are поэт.
suspitio |  suspitio, onis f
sustentaculum |  sustentaculum, i n
sustento |  sustento, avi, atum, are
sustineo |  sustineo, tinui, tentum, ere
sustollo |  sustollo, --, --, ere
sustr |  sustr...
sustuli |  sustuli см.
susurro |  susurro, --, --, are
susurrus |  I susurrus, a, um m
sutilis |  sutilis, e
sutor |  sutor, oris m
sutrina |  sutrina, ae f
sutura |  sutura, ae f
suum |  suum, i n
suus |  suus, a, um
Sybaris |  Sybaris, is f
Sybarita |  Sybarita, ae m
syllaba |  syllaba, ae f
syllabatim |  syllabatim adv.
symbiosis |  symbiosis, is f
sympathia |  sympathia, ae f
sympathicus |  sympathicus, a, um анат.
symphonia |  symphonia, ae f
symphoniacus |  symphoniacus, a, um
symphysialis |  symphysialis, e анат.
symphysis |  symphysis, is f
symposium |  symposium, i n
symptomaticus |  symptomaticus, a, um мед.
synapsis |  synaps(is), is f
synarthrosis |  synarthrosis, is f
synchondrosis |  synchondrosis, is f
syndactylia |  syndactylia, ae f
syndesmosis |  syndesmosis, is f
syndromum |  syndromum, i n
synedrus |  synedrus, i m
synergismus |  synergismus, i m
syngrapha |  syngrapha, ae f
synodus |  I synodus, i f
synostosis |  synostosis, is f
synovia |  synovia, ae f
synovialis |  synovialis, e анат.
sypdesmologia |  sypdesmologia, ae f
Syracusae |  Syracusae, arum f
Syri |  Syri, orum m
systema |  systema, atis n
systematicus |  systematicus, a, um анат.
systole |  systole, es f
