tabacum |  tabacum, i n
tabella |  tabella, ae f
tabellarius |  I tabellarius, a, um m
tabeo |  tabeo, --, --, ere поэт.
taberna |  taberna, ae f
tabernaculum |  tabernaculum, i n
tabernarius |  tabernarius, i m
tabes |  tabes, is f
tabesco |  tabesco, tabui, --, ere
tabidulus |  tabidulus, a, um
tabidus |  tabidus, a, um
tabula |  tabula, ae f
tabularium |  tabularium, i n
tabulatio |  tabulatio, onis f
tabulatum |  tabulatum, i n
tabuletta |  tabuletta, ae f
tabum |  tabum, i n
taceo |  taceo, tacui, tacitum, ere
Tachmalinum |  Tachmalin(um, i n
tachycardia |  tachycardia, ae f
tachyphagia |  tachyphagia, ae f
Tachystinum |  Tachystin(um, i n
Tacita |  Tacita, ae f
tacite |  tacite adv.
tacitum |  tacitum, i n
taciturnitas |  taciturnitas, atis f
taciturnus |  taciturnus, a, um поэт.
tacitus |  I tacitus, a, um m
Tactaranum |  Tactaran(um, i n
tactilis |  tactilis, e анат.
tactus |  I tactus, a, um m
taeda |  taeda (teda), ae f
taedet |  taedet, taeduit impers.
taedifer |  taedifer, era, erum
taedium |  taedium, i n
Taenaros |  Taenaros, i m
Taenarum |  Taenarum, i n
taenia |  taenia, ae f
taet |  taet...
tagimentum |  tagimentum, i n
talaria |  talaria, ium n
talaris |  talaris, e анат.
Talcum |  Talcum, i n
talea |  talea, ae f
talentum |  talentum, i n
taleonarius |  taleonarius, i m
Talidinum |  Talidin(um, i n
talio |  talio, onis f
talis |  talis, e
Talisulfazolum |  Talisulfazol(um, i n
talocalcaneonavicularis |  talocalcaneonavicularis, e анат.
talocalcaneus |  talocalcaneus, a, um анат.
talocruralis |  talocruralis, e
Talofenum |  Talofen(um, i n
talofibularis |  talofibularis, e анат.
talonavicularis |  talonavicularis, e анат.
talpa |  talpa, ae f
talus |  talus, i m
tam |  tam adv.
tamdiu |  tamdiu
tamen |  tamen adv.
tamenetsi |  tamenetsi conj.
Tamesa |  Tamesa, ae f
tametsi |  tametsi conj.
tamquam |  tamquam adv.
Tanager |  Tanager, gri m
Tanais |  Tanais, idis (is) m
Tanakanum |  Tanakan(um, i n
tandem |  tandem adv.
tango |  tango, tetigi, tactum, ere поэт.
Tannalbinum |  Tannalbin(um, i n
tanquam |  tanquam
Tantalides |  Tantalides, ae m
Tantalis |  Tantalis, idis (idos) f
Tantalos |  Tantalos (-us), i m
tantisper |  tantisper adv.
tanto |  tanto adv.
tantopere |  tantopere (также раздельно tanto opere) adv.
tantulum |  tantulum, i n
tantulus |  tantulus, a, um
tantum |  I tantum adv.
tantummodo |  tantummodo
tantus |  tantus, a, um
tantusdem |  tantusdem, tantadem, tantumdem (tantundem)
Tapazolum |  Tapazol(um, i n
tapes |  tapes, etis m
tapetum |  tapetum, i n
Taractanum |  Taractan(um, i n
Tarasanum |  Tarasan(um, i n
Taraxacum |  Taraxacum, i n
Tarchocinum |  Tarchocin(um, i n
tarde |  tarde adv.
Tardilum |  Tardil(um, i n
tarditas |  tarditas, atis f
tardo |  tardo, avi, atum, are
Tardocillinum |  Tardocillin(um, i n
tardus |  tardus, a, um поэт.
Tarentum |  Tarentum, i n
Tarpejus |  Tarpejus, a, um
Tarquinii |  Tarquinii, orum m
Tarquinius |  Tarquinius, i m
Tarraco |  Tarraco, onis f
tarsalis |  tarsalis, e
tarseus |  tarseus а, um
tarsometatarseus |  tarsometatarseus, a, um анат.
tarsus |  tarsus, i m
Tartareus |  Tartareus, a, um
Tartaros |  Tartaros (-us), i m
Tasnonum |  Tasnon(um, i n
Tatius |  Tatius Titus m
Tauremisinum |  Tauremisin(um, i n
taureus |  taureus, a, um
Tauri |  Tauri, orum m
tauriformis |  tauriformis, e
taurinus |  taurinus, a, um
Taurus |  Taurus, i m
taurus |  taurus, i m
taxatio |  taxatio, onis f
taxo |  taxo, avi, atum, are
taxonomia |  taxonomia, ae f
Taxoptera |  Taxoptera, ae f
taxus |  taxus, i f
Tazepamum |  Tazepam(um, i n
te |  te acc.
Tebethionum |  Tebethion(um, i n
Tebexinum |  Tebexin(um, i n
Tebrazidum |  Tebrazid(um, i n
Tebrophenum |  Tebrophen(um, i n
tecte |  tecte adv.
tector |  tector, oris m
tectorium |  tectorium, i n
tectorius |  tectorius, a, um анат.
tectum |  tectum, i n
tectus |  tectus, a, um
Teebacinum |  Teebacin(um, i n
Tegea |  Tegea, ae f
Tegeaeus |  Tegeaeus (Tegeeus), а, um
tegimen |  tegimen (tegumen, tegmen), inis n
tegimentum |  tegimentum (tegumentum, tegmentum), i n
tegm |  tegm...
tegmen |  tegmen, inis n
tegmentalis |  tegmentalis, e анат.
tegmentum |  tegmentum, i n
tego |  tego, texi, tectum, ere
Tegretalum |  Tegretal(um, i n
Tegretolum |  Tegretol(um, i n
tegula |  tegula, ae f
tegum |  tegum...
tela |  I tela, ae f
Telamon |  Telamo(n), onis m
Telemachus |  Telemachus, i m
telencephalon |  telencephalon, i m
Telepaquum |  Telepaqu(um, i n
Teletrastum |  Teletrast(um, i n
tellus |  tellus, uris f
Telmecidum |  Telmecid(um, i n
Telmidum |  Telmid(um, i n
Telminum |  Telmin(um, i n
telum |  telum, i n
Temechinum |  Temechin(um, i n
temerarius |  temerarius, a, um
temere |  temere adv.
temeritas |  temeritas, atis f
temero |  temero, avi, atum, are
Temetilum |  Temetil(um, i n
temetum |  temetum, i n
temno |  temno, --, --, ere
temo |  temo, onis m
Temparinum |  Temparin(um, i n
Tempe |  Tempe n
temperamentum |  temperamentum, i n
temperans |  temperans, antis
temperantia |  temperantia, ae f
temperatio |  temperatio, onis f
temperatus |  temperatus, a, um
temperi |  temperi adv.
temperies |  temperies, ei f
tempero |  tempero, avi, atum, are поэт.
tempestas |  tempestas, atis f
tempestive |  tempestive adv.
tempestivo |  tempestivo adv.
tempestivus |  tempestivus, a, um
templum |  templum, i n
temporalis |  temporalis, e анат.
temporarius |  temporarius, a, um
tempori |  tempori adv.
temporomandibularis |  temporomandibularis, e анат.
temporoparietalis |  temporoparietalis, e анат.
temporozygomaticus |  temporozygomaticus, a, um анат.
Temposilum |  Temposil(um, i n
tempt |  tempt...
tempus |  I tempus, oris n
temulentus |  temulentus, a, um
tenacitas |  tenacitas, atis f
tenaciter |  tenaciter adv.
tenax |  tenax, acis
Tencteri |  Tencteri, orum (um) m
tendiculae |  tendiculae, arum f
tendineus |  tendineus, a, um анат.
tendinosus |  tendinosus, a, um анат.
tendo |  I tendo, inis m
tendovaginitis |  tendovaginitis, idis f
Teneatum |  Teneat(um, i n
tenebrae |  tenebrae, arum f
tenebricosus |  tenebricosus, a, um
tenebrosus |  tenebrosus, a, um
teneo |  teneo, tenui, tentum, ere воен.
tener |  tener, era, erum
tenericutis |  tenericutis, e биолог.
tenesmos |  tenesmos, i m
tenia |  tenia, ae f
Teniarenum |  Teniaren(um, i n
Teniathanum |  Teniathan(um, i n
Tenicridinum |  Tenicridin(um, i n
Teniotolum |  Teniotol(um, i n
tenoplastica |  tenoplastica, ae f
tenor |  tenor, oris m
tenorrhaphia |  tenorrhaphia, ae f
tenotomia |  tenotomia, ae f
tensa |  tensa, ae f
Tenserpinum |  Tenserpin(um, i n
Tensofinum |  Tensofin(um, i n
Tensonalum |  Tensonal(um, i n
tensor |  tensor, oris m
tensus |  tensus, a, um анат.
tentabundus |  tentabundus, a, um
tentamen |  tentamen, inis n
tentamentum |  tentamentum, i n
tentatio |  tentatio, onis f
tentator |  tentator, oris m
tentigo |  tentigo, inis f
tento |  tento, avi, atum, are поэт.
tentoriolum |  tentoriolum, i n
tentorium |  tentorium, i n
tentus |  tentus, a, um part.
tenuis |  tenuis, e
tenuitas |  tenuitas, atis f
tenuiter |  tenuiter adv.
tenuo |  tenuo, avi, atum, are
tenus |  tenus praep.
Teofenum |  Teofen(um, i n
Teos |  Teos, i f
Tepanilum |  Tepanil(um, i n
tepefacio |  tepefacio, feci, factum, ere
tepeo |  tepeo, --, --, ere
tepesco |  tepesco, tepui, --, ere
tepidus |  tepidus, a, um поэт.
tepor |  tepor, oris m
ter |  ter adv.
Teraplixum |  Teraplix(um, i n
terdecies |  terdecies (terdeciens) adv.
terebinthus |  terebinthus, i f
terebra |  terebra, ae f
terebro |  terebro, avi, atum, are
teredo |  teredo, inis f
Terentius |  Terentius, a, um
teres |  teres, etis
Terfluzinum |  Terfluzin(um, i n
tergeminus |  tergeminus, a, um
tergeo |  tergeo, tersi, tersum, ere
Tergeste |  Tergeste, is n
tergiversatio |  tergiversatio, onis f
tergiversor |  tergiversor, atus sum, ari
tergo |  tergo, tersi, tersum, ere
tergum |  tergum, i n
tergus |  tergus, oris n
Teridinum |  Teridin(um, i n
termes |  termes, itis m
Terminalia |  Terminalia, ium (orum) n
terminalis |  terminalis, e
terminatio |  I terminatio, onis f
termino |  termino, avi, atum, are
Terminus |  Terminus, i m
terminus |  terminus, i m
terni |  terni, ae, a
tero |  tero, trivi, tritum, ere поэт.
Terpsichore |  Terpsichore, es f
terra |  terra, ae f
Terramycinum |  Terramycin(um, i n
terrenum |  terrenum, i n
terrenus |  terrenus, a, um поэт.
terreo |  terreo, terrui, territum, ere
terrester |  terrester, stris, stre
terreus |  terreus, a, um
terribilis |  terribilis, e
terricola |  terricola, ae f
terriculum |  terriculum, i n
terrifico |  terrifico, --, --, are
terrificus |  tcrrificus, a, um
terrigena |  terrigena, ae m
territo |  territo, avi, --, are
territorium |  territorium, i n
terror |  terror, oris m
tersus |  tersus, a, um
tertio |  tertio adv.
tertium |  tertium adv.
tertius |  tertius, a, um поэт.
tesca |  tesca (tesqua), orum n
Tespaminum |  Tespamin(um, i n
tessera |  tessera, ae f
testa |  testa, ae f
testamentarius |  I testamentarius, a, um m
testamentum |  testamentum, i n
testatio |  testatio, onis f
testatus |  testatus, a, um
testicularis |  testicularis, e анат.
testiculus |  testiculus, i m
testificatio |  testificatio, onis f
testificor |  testificor, atus sum, ari
testimonium |  testimonium, i n
testis |  I testis, is m
Testobromlecithum |  Testobromlecith(um, i n
Testodiolum |  Testodiol(um, i n
Testoenatum |  Testoenat(um, i n
Testolutinum |  Testolutin(um, i n
testor |  testor, atus sum, ari
Testoralum |  Testoral(um, i n
testu |  testu n
testudo |  testudo, inis f
testula |  testula, ae f
teter |  teter (taeter), tra, trum
Tethys |  Tethys, yos f
Tetrabonum |  Tetrabon(um, i n
Tetraboras |  Tetraboras, atis m
Tetraceminum |  Tetracemin(um, i n
Tetrachloraethylenum |  Tetrachloraethylen(um, i n
tetrachmum |  tetrachmum (tetradrachmum), i n
Tetracoccus |  Tetracoccus, i m
Tetracyclini |  Tetracyclini hydrochloridum
Tetracyclinum |  Tetracyclin(um, i n
Tetracynum |  Tetracyn(um, i n
Tetradinum |  Tetradin(um, i n
tetrandrus |  tetrandrus, a, um биолог.
Tetranum |  Tetran(um, i n
Tetraoleanum |  Tetraolean(um, i n
tetraphyllus |  tetraphyllus, a, um биолог.
tetrapodus |  tetrapodus, a, um биолог.
tetrapus |  tetrapus, odos биолог.
tetrarches |  tetrarches, ae m
tetrarchia |  tetrarchia, ae f
Tetravitum |  Tetravit(um, i n
tetre |  tetre (taetre) adv.
tetricus |  tetricus, a, um
Tetridinum |  Tetridin(um, i n
tetrodontus |  tetrodontus, a, um биолог.
Teturamum |  Teturam(um, i n
Teucer |  Teucer, cri m
Teucri |  Teucri, orum m
Teutones |  Teutones, um m
Teutonicus |  Teutonicus, a, um
Teviralum |  Teviral(um, i n
texo |  texo, texui, textum, ere поэт.
textile |  textile, is n
textilis |  textilis, e
textor |  textor, oris m
textrinum |  textrinum, i n
textum |  textum, i n
thalamencephalon |  thalamencephalon, i n
thalamicus |  thalamicus, a, um анат.
thalamocorticalis |  thalamocorticalis, e анат.
Thalamonalum |  Thalamonal(um, i n
thalamostriatus |  thalamostriatus, a, um анат.
thalamus |  I thalamus, i m
Thalazolum |  Thalazol(um, i n
Thalazonum |  Thalazon(um, i n
Thales |  Thales, is (etis) m
Thalia |  Thalia, ae f
Thapsos |  Thapsos (-us), i f
Theadrylum |  Theadryl(um, i n
Thealbinum |  Thealbin(um, i n
theatralis |  theatralis, e
theatrum |  theatrum, i n
Thebae |  Thebae, arum f
Thebanus |  Thebanus, a, um
theca |  theca, ae f
Thecodinum |  Thecodin(um, i n
Theelinum |  Theelin(um, i n
Thefylanum |  Thefylan(um, i n
Theinum |  Thein(um, i n
Thelestrinum |  Thelestrin(um, i n
Thelykininum |  Thelykinin(um, i n
Theminalum |  Theminal(um, i n
Themis |  Themis, idis f
Themisalum |  Themisal(um, i n
Themistocles |  Themistocles, is (i) m
thenar |  thenar, aris n
thensa |  thensa
thensaurus |  thensaurus
Theobrominum |  Theobromin(um, i n
Theobrosalum |  Theobrosal(um, i n
Theocinum |  Theocin(um, i n
Theocritus |  Theocritus, i m
Theodinalum |  Theodinal(um, i n
Theodosia |  Theodosia, ae f
Theogonia |  Theogonia, ae f
Theophedrinum |  Theophedrin(um, i n
Theophorinum |  Theophorin(um, i n
Theophyllaminum |  Theophyllamin(um, i n
Theophyllinum |  Theophyllin(um, i n
Theosanum |  Theosan(um, i n
Theoverinum |  Theoverin(um, i n
Thepalusalum |  Thepalusal(um, i n
Thepaphyllinum |  Thepaphyllin(um, i n
Thephorinum |  Thephorin(um, i n
Thermae |  Thermae, arum f
thermae |  thermae, arum f
thermophorum |  thermophorum, i n
Thermopium |  Thermopium, i n
Thermopsis |  Thermopsis, idis f
Thermopylae |  Thermopylae, arum f
thermotaxis |  thermotaxis, is f
therotrophium |  therotrophium, i n
Thersites |  Thersites, ae m
Thesalbenum |  Thesalben(um, i n
Thesaminalum |  Thesaminal(um, i n
Thesanum |  Thesan(um, i n
thesaurus |  thesaurus (thensaurus), i m
Theseus |  Theseus (=These^us), ei (eos) m
Thespis |  Thespis, idis m
Thessalia |  Thessalia, ae f
Thessalicus |  Thessalicus (Thessalius), а, um
Thessalonica |  Thessalonica, ae f
Thetis |  Thetis, idis f
Thiamazolum |  Thiamazol(um, i n
Thiaminum |  Thiaminum, i n
Thianidum |  Thianid(um, i n
Thiantanum |  Thiantan(um, i n
thiasus |  thiasus, i m
Thiazamidum |  Thiazamid(um, i n
Thibutolum |  Thibutol(um, i n
Thimecilum |  Thimecil(um, i n
Thioacetazonum |  Thioacetazon(um, i n
Thiobutalum |  Thiobutal(um, i n
Thioctacidum |  Thioctacid(um, i n
Thioctanum |  Thioctan(um, i n
Thiodipinum |  Thiodipin(um, i n
Thiomecilum |  Thiomecil(um, i n
Thiomedonum |  Thiomedon(um, i n
Thiomicidum |  Thiomicid(um, i n
Thiomidilum |  Thiomidil(um, i n
Thionembutalum |  Thionembutal(um, i n
Thionidum |  Thionid(um, i n
Thiopentalum |  Thiopentalum-natrium, Thiopentali-natrii n
Thiopentenum |  Thiopenten(um, i n
Thiopentobarbitalum |  Thiopentobarbital(um, i n
Thioperazinum |  Thioperazin(um, i n
Thiophanium |  Thiophanium, i n
Thioridazinum |  Thioridazin(um, i n
Thiorylum |  Thioryl(um, i n
Thiosarminum |  Thiosarmin(um, i n
Thiospasminum |  Thiospasmin(um, i n
Thiosulfas |  Thiosulfas, atis m
Thiotepum |  Thiotep(um, i n
Thiothyronum |  Thiothyron(um, i n
Thisbe |  Thisbe, es f
tholus |  tholus, i m
thoracalis |  thoracalis, e анат.
thoracicoacromialis |  thoracicoacromialis, e анат.
thoracicus |  thoracicus, a, um анат.
thoracodorsalis |  thoracodorsalis, e анат.
thoracoepigastricus |  thoracoepigastricus, a, um анат.
thoracolumbalis |  thoracolumbalis, e анат.
thoras |  thoras, acis m
Thorazinum |  Thorazin(um, i n
Thraca |  Thraca, ae f
Thrace |  Thraca, ae f
Thraces |  Thraces, um m
Thracia |  Thracia, ae f
Thracius |  Thracius, a, um
Thrax |  I Thrax, acis m
Thromasalum |  Thromasal(um, i n
Thrombantinum |  Thrombantin(um, i n
Thrombinum |  Thrombin(um, i n
thrombocytopenia |  thrombocytopenia, ae f
thrombocytosis |  thrombocytosis, is f
thrombocytus |  thrombocytus, i m
Thromboliquinum |  Thromboliquin(um, i n
Thrombolysinum |  Thrombolysin(um, i n
Thrombolytinum |  Thrombolytin(um, i n
Thrombophenum |  Thrombophen(um, i n
thrombophilia |  thrombophilia, ae f
thrombophlebitis |  thrombophlebitis, idis f
Thrombosolum |  Thrombosol(um, i n
Thrombotylum |  Thrombotyl(um, i n
thrombus |  thrombus, i m
Thucydides |  Thucydides, is (i) m
thunnus |  thunnus, i m
thur |  thur...
thus |  thus
thyasus |  thyasus
Thycapzolum |  Thycapzol(um, i n
thymbra |  thymbra, ae f
thymicus |  thymicus, a, um анат.
Thymidazolum |  Thymidazol(um, i n
Thymolum |  Thymol(um, i n
thymum |  thymum, i n
thymus |  I thymus, i m
thynnus |  thynnus (thunnus), i m
Thyranonum |  Thyranon(um, i n
Thyreoidinum |  Thyreoidin(um, i n
thyroarytenoideus |  thyroarytenoideus, a, um анат.
thyrocervicalis |  thyrocervicalis, e анат.
thyroepiglotticus |  thyroepiglotticus, a, um анат.
thyrohyoideus |  thyrohyoideus, a, um анат.
thyroideus |  thyroideus, a, um
Thyroidum |  Thyroid(um, i n
thyropharyngeus |  thyropharyngeus, a, um анат.
Thyrosinum |  Thyrosin(um, i n
Thyrotanum |  Thyrotan(um, i n
Thyrotropinum |  Thyrotropin(um, i n
thyrsus |  thyrsus, i m
Ti. |  Ti. сокр. от
tiara |  tiara, ae f
Tiberis |  Tiberis, is ( acc.
Tiberius |  Tiberius, i m
tibia |  tibia, ae f
tibiale |  tibiale, is n
tibialis |  tibialis, e анат.
tibicen |  tibicen, inis m
tibicina |  tibicina, ae f
tibicinium |  tibicinium, i n
tibiocalcaneus |  tibiocalcaneus, a, um анат.
tibiofibularis |  tibiofibularis, e анат.
tibionavicularis |  tibionavicularis, e анат.
Tibionum |  Tibion(um, i n
tibiotalaris |  tibiotalaris, e анат.
Tibisanum |  Tibisan(um, i n
Tibizidum |  Tibizid(um, i n
Tibonum |  Tibon(um, i n
Tibullus |  Tibullus, i m
Tibur |  Tibur, uris n
Tibutolum |  Tibutol(um, i n
Ticinus |  Ticinus, i m
Tigellinus |  Tigellinus, i m
Tigellius |  Tigellius, i m
tigillum |  tigillum, i n
tignarius |  tignarius, a, um
tignum |  tignum, i n
tigrinus |  tigrinus, a, um биолог.
Tigris |  Tigris, is (idis) m
tigris |  tigris, idis (is) m
Tilcyprinum |  Tilcyprin(um, i n
tilia |  tilia, ae f
Timaeus |  Timaeus, i m
timefactus |  timefactus, a, um
timeo |  timeo, ui, --, ere
timide |  timide adv.
timiditas |  timiditas, atis f
timidus |  timidus, a, um
timor |  timor, oris m
Timosinum |  Timosin(um, i n
tinctilis |  tinctilis, e
tinctura |  tinctura, ae f
tinea |  tinea (tinia), ae f
tingo |  tingo (tinguo), tinxi, tinctum, ere
tinia |  tinia, ae f
tinnio |  tinnio (tinio), ivi (ii), itum, ire
tinnitus |  tinnitus, us m
tinnulus |  tinnulus, a, um
tintinnabulum |  tintinnabulum, i n
tinus |  tinus, i f
Tioctacidum |  Tioctacid(um, i n
Tioctanum |  Tioctan(um, i n
Tiofosylum |  Tiofosyl(um, i n
Tiopanum |  Tiopan(um, i n
Tiotioronum |  Tiotioron(um, i n
Tiphenum |  Tiphen(um, i n
Tiresias |  Tiresias, ae m
Tirianum |  Tirian(um, i n
tiro |  tiro, onis m
tirocinium |  tirocinium, i n
Tisiphone |  Tisiphone, es f
Tisomycinum |  Tisomycin(um, i n
Titan |  Titan, anis m
Titanis |  Titanis, idis (idos) f
Titanus |  Titanus, i m
Titienses |  Titienses, ium m
titillo |  titillo, avi, atum, are
titubanter |  titubanter adv.
titubo |  titubo, avi, atum, are
titulus |  titulus, i m
Titus |  Titus, i m
Tizonum |  Tizon(um, i n
Tochlorinum |  Tochlorin(um, i n
Toclasum |  Toclas(um, i n
Tocofynum |  Tocofyn(um, i n
Tofranilum |  Tofranil(um, i n
tofus |  tofus (tophus), i m
toga |  toga, ae f
togata |  togata, ae f
togatus |  I togatus, a, um m
togula |  togula, ae f
Tolaminum |  Tolamin(um, i n
Tolazolinum |  Tolazolin(um, i n
Tolbusalum |  Tolbusal(um, i n
Tolbutamidum |  Tolbutamid(um, i n
tolerabilis |  tolerabilis, e
tolerandus |  tolerandus, a, um
tolero |  tolero, avi, atum, are
Tolinonum |  Tolinon(um, i n
tolleno |  tolleno, onis m
tollo |  tollo, sustuli, sublatum, ere воен.
Tolosa |  Tolosa, ae f
Tolserolum |  Tolserol(um, i n
Tolumidum |  Tolumid(um, i n
Toluvanum |  Toluvan(um, i n
tomentum |  tomentum, i n
Tomi |  Tomi, orum m
tomographia |  tomographia, ae f
tondeo |  tondeo, totondi, tonsum, ere поэт.
Tonedronum |  Tonedron(um, i n
tonitrus |  tonitrus, us m
tono |  tono, tonui, --, are impers.
Tonocardum |  Tonocard(um, i n
Tonocholinum |  Tonocholin(um, i n
Tonogenum |  Tonogen(um, i n
Tonolitum |  Tonolit(um, i n
tonsa |  tonsa, ae f
tonsilla |  tonsilla, ae f
tonsillaris |  tonsillaris, e анат.
tonsillectomia |  tonsillectomia, ae f
tonsillitis |  tonsillitis, idis f
tonsillotomia |  tonsillotomia, ae f
tonsor |  tonsor, oris; m
tonsura |  tonsura, ae f
tonus |  tonus, i m
Topanalginum |  Topanalgin(um, i n
Tophosanum |  Tophosan(um, i n
tophus |  tophus
Topica |  Topica, orum n
Topiclynum |  Topiclyn(um, i n
Topocainum |  Topocain(um, i n
topographicus |  topographicus, a, um
Toraflonum |  Toraflon(um, i n
toral |  toral, alis n
toreuma |  toreuma, atis n
Torfotum |  Torfot(um, i n
Torinalum |  Torinal(um, i n
tormentum |  tormentum, i n
torno |  torno, avi, atum, are
tornus |  tornus, i m
torosus |  torosus, a, um
torpedo |  torpedo, inis f
torpeo |  torpeo, --, --, ere
torpesco |  torpesco, pui, --, ere
torpidus |  torpidus, a, um
torpor |  torpor, oris m
torquatus |  torquatus, a, um
torqueo |  torqueo, torsi, tortum, ere поэт.
torquis |  torquis (torques), is m
torrens |  I torrens, entis m
torreo |  torreo, torrui, tostum, ere
torridus |  torridus, a, um
torris |  torris, is m
tortilis |  tortilis, e
tortor |  tortor, oris m
tortuosus |  tortuosus, a, um
tortus |  I tortus, a, um m
Torulinum |  Torulin(um, i n
torus |  torus, i m
torvus |  torvus, a, um
Tosmilenum |  Tosmilen(um, i n
tot |  tot indecl.
totalis |  totalis, e мед.
Totapenum |  Totapen(um, i n
totidem |  totidem indecl.
toties |  toties (totiens) adv.
totum |  totum, i n
totus |  totus, a, um gen.
toxaemia |  toxaemia, ae f
Toxapinum |  Toxapin(um, i n
toxicologia |  toxicologia, ae f
toxicon |  toxicon n
toxicophobia |  toxicophobia, ae f
toxicosis |  toxicosis, is f
toxicus |  toxicus, a, um мед.
trabalis |  trabalis, e
trabea |  trabea, ae f
trabeatus |  trabeatus, a, um
trabecula |  trabecula, ae f
trabs |  trabs, trabis f
trachea |  trachea, ae f
trachealis |  trachealis, e анат.
tracheobronchialis |  tracheobronchialis, e анат.
Trachiniae |  Trachiniae, arum f
tractabilis |  tractabilis, e
tractatio |  tractatio, onis f
tractatus |  tractatus, us m
tractim |  tractim adv.
tracto |  tracto, avi, atum, are
tractus |  tractus, us m
traditio |  traditio, onis f
trado |  trado, didi, ditum, ere
Tradonum |  Tradon(um, i n
traduco |  traduco (transduco), duxi, ductum, ere
traductio |  traductio, onis f
tragi |  tragi, orum m
tragicus |  tragicus, a, um анат.
tragoedia |  tragoedia, ae f
tragoedus |  tragoedus, i m
tragula |  tragula, ae f
tragus |  tragus, i m
trahea |  trahea, ae f
traho |  traho, traxi, tractum, ere поэт.
traicio |  traicio
Trajanus |  Trajanus, i m
trajectus |  trajectus, us m
trajicio |  trajicio (transjicio), jeci, jectum, ere
tralaticius |  tralaticius
tralatio |  tralatio
tralatus |  tralatus, a, um part.
traluceo |  traluceo
trames |  trames, itis m
tramigro |  tramigro
tramitto |  tramitto
tranato |  tranato (transnato), avi, atum, are
Trancocardum |  Trancocard(um, i n
trano |  trano (transno), avi, atum, are
Tranquilanum |  Tranquilan(um, i n
Tranquilinum |  Tranquilin(um, i n
tranquillitas |  tranquillitas, atis f
tranquillo |  I tranquillo adv.
tranquillum |  tranquillum, i n
tranquillus |  tranquillus, a, um
Tranquilum |  Tranquil(um, i n
Tranquisanum |  Tranquisan(um, i n
trans |  trans praep.
transabeo |  transabeo, ii, --, ire
transactor |  transactor, oris m
transadigo |  transadigo, egi, actum, ere
transalpinus |  transalpinus, a, um
Transaminum |  Transamin(um, i n
transcendo |  transcendo (transscendo), scendi, scensum, ere
transcribo |  transcribo (transscribo), scripsi, scriptum, ere юр.
transcurro |  transcurro, cucurri (curri), cursum, ere
transdo |  transdo
transduco |  transduco
transeo |  transeo, ii, itum, ire поэт.
transfero |  transfero (trafero), transtuli, translatum (tralatum), transferre
transfigo |  transfigo, fixi, fixum, ere
transfodio |  transfodio, fodi, fossum, ere
transformis |  transformis, e
transformo |  transformo, avi, atum, are
transfuga |  transfuga, ae m
transfugio |  transfugio, fugi, fugitum, ere
transfugium |  transfugium, i n
transfundo |  transfundo, fudi, fusum, ere pass.
transfusio |  transfusio, onis f
transgredior |  transgredior, gressus sum, gredi
transgressio |  transgressio, onis f
transigo |  transigo, egi, actum, ere
transilio |  transilio (transsilio), ui (ivi), --, ire
transitio |  transitio, onis f
transitus |  transitus, us m
transject |  transject...
transjicio |  transjicio
translaticius |  translaticius (tralaticius), a, um
translatio |  translatio (tralatio), onis f
translator |  translator, oris m
transluceo |  transluceo (traluceo), --, --, ere
transmarinus |  transmarinus, a, um
transmigro |  transmigro, avi, atum, are
transmissio |  transmissio, onis f
transmissus |  transmissus, us m
transmitto |  transmitto (tramitto), misi, missum, ere
transmontani |  transmontani, orum m
transmuto |  transmuto, --, --, are
transn |  transn...
transpadani |  transpadani, orum m
transpadanus |  transpadanus, a, um
transplantatio |  transplantatio, onis f
transplantatum |  transplantatum, i n
transplantologia |  transplantologia, ae f
transporto |  transporto, avi, atum, are
transrhenani |  transrhenani, orum m
transrhenanus |  transrhenanus, a, um
transs |  transs...
transtrum |  transtrum, i n
transulto |  transulto, --, --, are
transuo |  transuo (transsuo), sui, sutum, ere
transveho |  transveho, vexi, vectum, ere pass.
transverbero |  transverbero, avi, atum, are
transversa |  transversa adv.
transversalis |  transversalis, e анат.
transversarius |  transversarius (traversarius), a, um
transversospinalis |  transversospinalis, e анат.
transversum |  I transversum (transvorsum) adv.
transversus |  transversus (transvorsus, traversus, travorsus), a, um
transvolo |  transvolo (travolo), avi, atum, are
transvors |  transvors...
Tranykyprominum |  Tranykypromin(um, i n
Trapanalum |  Trapanal(um, i n
trapetum |  trapetum, i n
trapezium |  trapezium, i n
trapezius |  trapezius, a, um анат.
trapezoideus |  trapezoideus, a, um
Trasentinum |  Trasentin(um, i n
Trasylolum |  Trasylol(um, i n
trauma |  trauma, atis n
traumaticus |  traumaticus, a, um мед.
traveho |  traveho
traversarius |  traversarius, a, um см.
travolo |  travolo
Traxalum |  Traxal(um, i n
Trebia |  Trebia, ae f
Trecatorum |  Trecator(um, i n
treceni |  treceni, ae, a
trecentesimus |  trecentesimus, a, um
trecenti |  trecenti, ae, a
tredecim |  tredecim
tremebundus |  tremebundus (tremibundus), a, um
tremefacio |  tremefacio, feci, factum, ere
tremendus |  tremendus, a, um
tremesco |  tremesco (tremisco), --, --, ere поэт.
tremibundus |  tremibundus, a, um
tremisco |  tremisco, --, --, ere
tremo |  tremo, mui, --, ere
tremor |  tremor, oris m
tremulus |  tremulus, a, um поэт.
Trepalum |  Trepal(um, i n
trepidanter |  trepidanter adv.
trepidatio |  trepidatio, onis f
trepide |  trepide adv.
trepido |  trepido, avi, atum, are
trepidus |  trepidus, a, um поэт.
tres |  tres ( арх.
Trescatylum |  Trescatyl(um, i n
Tresochinum |  Tresochin(um, i n
tresviri |  tresviri, orum m
Tretaminum |  Tretamin(um, i n
Trethylenum |  Trethylen(um, i n
Treventixum |  Treventix(um, i n
Treveri |  Treveri (Treviri), orum m
Trevintixum |  Trevintix(um, i n
Triacetyloleandomycinum |  Triacetyloleandomycin(um, i n
Triadenylum |  Triadenyl(um, i n
Triamcinolonum |  Triamcinolon(um, i n
Triamcortum |  Triamcort(um, i n
Triamterenum |  Triamteren(um, i n
Triamterilum |  Triamteril(um, i n
triangularis |  triangularis, e анат.
triangulum |  triangulum, i n
Trianisoestrolum |  Trianisoestrol(um, i n
triarii |  triarii, orum m
triaxonalis |  triaxonalis, e биолог.
Tribenozidum |  Tribenozid(um, i n
tribolus |  tribolus (tribulus), i m
tribuarius |  tribuarius, a, um
tribulis |  tribulis, is m
tribulum |  tribulum, i n
tribulus |  tribulus
tribunal |  tribunal, alis n
tribunatus |  tribunatus, us m
tribunicius |  I tribunicius, a, um m
tribunus |  tribunus, i m
tribuo |  tribuo, bui, butum, ere
tribus |  tribus, us f
tributarius |  tributarius, a, um
tributim |  tributim adv.
tributum |  tributum, i n
tributus |  I tributus, a, um part.
triceni |  triceni, ae, a gen.
triceps |  triceps, ipitis
tricesimus |  tricesimus (trigesimus), a, um
trichalgia |  trichalgia, ae f
trichatrophia |  trichatrophia, ae f
Trichazolum |  Trichazol(um, i n
Trichexum |  Trichex(um, i n
trichila |  trichila, ae f
Trichloraethylenum |  Trichloraethylen(um, i n
Trichloranum |  Trichloran(um, i n
Trichlorathylenum |  Trichlorathylen(um, i n
Trichlorenum |  Trichloren(um, i n
trichocephalosis |  trichocephalosis, is f
Trichocephalus |  Trichocephalus, i m
Trichocidum |  Trichocid(um, i n
Trichofuronum |  Trichofuron(um, i n
trichoma |  trichoma, atis n
trichomycosis |  trichomycosis, is f
trichopathia |  trichopathia, ae f
Trichopolum |  Trichopol(um, i n
trichorrhoea |  trichorrhoea, ae f
trichosis |  trichosis, is f
tricies |  tricies (triciens) adv.
tris |  tris
Trisaminolum |  Trisaminol(um, i n
Trisaminum |  Trisamin(um, i n
Trisbufferum |  Trisbuffer(um, i n
Trisedylum |  Trisedyl(um, i n
Trispanum |  Trispan(um, i n
triste |  triste adv.
tristis |  tristis, e поэт.
tristitia |  tristitia, ae f
trisulcus |  trisulcus, a, um
triticeus |  triticeus, a, um анат.
triticum |  triticum, i n
Triton |  Triton, onis m
tritura |  tritura, ae f
tritus |  tritus, a, um поэт.
triumphalis |  triumphalis, e
triumpho |  triumpho, avi, atum, are поэт.
triumphus |  triumphus ( арх.
triumvir |  triumvir, iri m
triumviralis |  triumviralis, e
triumviratus |  triumviratus, us m
Trivasolum |  Trivasol(um, i n
trivium |  trivium, i n
trivius |  trivius, a, um
trochanter |  trochanter, eris m
trochantericus |  trochantericus, a, um анат.
Trochinum |  Trochin(um, i n
trochlea |  trochlea, ae f
trochlearis |  trochlearis, e анат.
trochoides |  trochoides, is
trochus |  trochus, i m
Trocinatum |  Trocinat(um, i n
Troformonum |  Troformon(um, i n
Troglodytae |  Troglodytae, arum m
Troia |  Troia, ae f
Trojani |  Trojani, orum m
Tromasedanum |  Tromasedan(um, i n
Trombantinum |  Trombantin(um, i n
Trombarinum |  Trombarin(um, i n
Trombexum |  Trombex(um, i n
Trombolysanum |  Trombolysan(um, i n
Trombosanum |  Trombosan(um, i n
Trombosolum |  Trombosol(um, i n
Trombostopum |  Trombostop(um, i n
Tropacinum |  Tropacin(um, i n
tropaeum |  tropaeum, i n
Tropaphenum |  Tropaphen(um, i n
trophoblastus |  trophoblastus, i m
trophocyti |  trophocyti, orum m
Tros |  Tros, Trois m
trossuli |  trossuli, orum m
Troxidonum |  Troxidon(um, i n
Troxilanum |  Troxilan(um, i n
trucidatio |  trucidatio, onis f
trucido |  trucido, avi, atum, are поэт.
truculenter |  truculenter adv.
truculentus |  truculentus, a, um
trudis |  trudis, is f
trudo |  trudo, trusi, trusum, ere поэт.
trulla |  trulla, ae f
trunco |  trunco, avi, atum, are
truncus |  I truncus, a, um m
trutina |  trutina, ae f
trux |  trux, trucis
Truxalum |  Truxal(um, i n
Truxilum |  Truxil(um, i n
Trychomyces |  Trychomyces, etis f
Tryenum |  Tryen(um, i n
Tryphthazinum |  Tryphthazin(um, i n
Tryptizolum |  Tryptizol(um, i n
Tsalolum |  Tsalol(um, i n
tu |  tu, tui pl.
tuba |  tuba, ae f
Tubadilum |  Tubadil(um, i n
tubalis |  tubalis, e анат.
Tubarinum |  Tubarin(um, i n
tubarius |  tubarius, a, um анат.
Tubazidum |  Tubazid(um, i n
tuber |  tuber, eris n
tuberalis |  tuberalis, e анат.
Tubercazonum |  Tubercazon(um, i n
tubercularis |  tubercularis, e анат.
tuberculosus |  tuberculosus, a, um мед.
tuberculum |  tuberculum, i n
tuberositas |  tuberositas, atis f
tuberosus |  tuberosus, a, um анат.
tubicen |  tubicen, inis m
tubilustria |  tubilustria, ium n
Tubocuranum |  Tubocuran(um, i n
tuboovaricus |  tuboovaricus, a, um анат.
Tubopasum |  Tubopas(um, i n
tubulus |  tubulus, i m
tubus |  tubus, i m
Tucodilum |  Tucodil(um, i n
tueor |  tueor, tuitus sum, tueri
tugurium |  tugurium, i n
Tullius |  Tullius, a, um
tum |  tum adv.
tumefacio |  tumefacio, feci, factum, ere
tumeo |  tumeo, --, --, ere поэт.
tumesco |  tumesco, tumui, --, ere
tumidus |  tumidus, a, um поэт.
tumor |  tumor, oris m
tumulo |  tumulo, avi, atum, are
tumulosus |  tumulosus, a, um
tumultuarius |  tumultuarius, a, um
tumultuatio |  tumultuatio, onis f
tumultuor |  tumultuor, atus sum, ari
tumultuose |  tumultuose adv.
tumultuosus |  tumultuosus, a, um
tumultus |  tumultus, us m
tumulus |  tumulus, i m
tunc |  tunc adv.
tundo |  tundo, tutudi, tunsum (tusum), ere
tunica |  tunica, ae f
tunicatus |  tunicatus, a, um
turba |  turba, ae f
turbamentum |  turbamentum, i n
turbate |  turbate adv.
turbatio |  turbatio, onis f
turbator |  turbator, oris m
turbatus |  turbatus, a, um
turbide |  turbide adv.
turbidum |  turbidum, i n
turbidus |  turbidus, a, um
turbineus |  turbineus, a, um
turbo |  I turbo, avi, atum, are поэт.
turbulente |  turbulente (turbulenter) adv.
turbulentus |  turbulentus, a, um
turcicus |  turcicus, a, um анат.
turdus |  turdus, i m
tureus |  tureus, a, um
turfa |  turfa, ae f
turgeo |  turgeo, tursi, --, ere
turgesco |  turgesco, --, --, ere
turgidus |  turgidus, a, um поэт.
turibulum |  turibulum, i n
turicremus |  turicremus, a, um
turifer |  turifer, era, erum
turilegus |  turilegus, a, um
turma |  turma, ae f
turmales |  turmales, ium m
turmatim |  turmatim adv.
Turnus |  Turnus, i m
turpe |  turpe, is n
turpis |  turpis, e
turpiter |  turpiter adv.
turpitudo |  turpitudo, inis f
turpo |  turpo, avi, atum, are
turriger |  turriger, era, erum
turris |  turris, is f
turritus |  turritus, a, um поэт.
turtur |  turtur, uris m
tus |  tus, turis n
Tusci |  Tusci, orum m
Tuscodinum |  Tuscodin(um, i n
Tusculanum |  Tusculanum, i n
Tusculum |  Tusculum, i m
Tussilago |  Tussilago, inis f
tussio |  tussio, --, --, ire
tussis |  tussis, is f
tutamen |  tutamen, inis n
tutamentum |  tutamentum, i n
tute |  I tute adv.
tutela |  tutela, ae f
tuto |  tuto adv.
tutor |  I tutor, atus sum, ari m
tutum |  tutum, i n
tutus |  tutus, a, um
tuus |  tuus, a, um
Tylciprinum |  Tylciprin(um, i n
Tylenolum |  Tylenol(um, i n
Tylinalum |  Tylinal(um, i n
tympanicus |  tympanicus, a, um анат.
tympanomastoideus |  tympanomastoideus, a, um анат.
tympanosquamosus |  tympanosquamosus, a, um анат.
tympanostapedius |  tympanostapedius, a, um анат.
tympanum |  tympanum, i n
Tyndareus |  Tyndareus (=Tyndare^us), ei m
typhlatonia |  typhlatonia, ae f
typhlectasia |  typhlectasia, ae f
typhlitis |  typhlitis, idis f
typhlostenosis |  typhlostenosis, is f
typhlotomia |  typhlotomia, ae f
Typhoeus |  Typhoeus (Typhoe^us), ei (eos) m
Typhomycinum |  Typhomycin(um, i n
tyrannice |  tyrannice adv.
tyrannicus |  tyrannicus, a, um
tyrannis |  tyrannis, idis f
tyrannus |  tyrannus, i m
Tyras |  Tyra(s), ae m
tyropatina |  tyropatina, ae f
Tyros |  Tyros (-us), i f
Tyrrheni |  Tyrrheni, orum m
