uber |  I uber, eris n
uberius |  uberius ( superl.
ubertas |  ubertas, atis f
ubi |  ubi adv.
ubicumque |  ubicumque (ubicunque,  арх.
Ubii |  Ubii, orum m
ubinam |  ubinam adv.
ubiquaque |  ubiquaque adv.
ubique |  ubique adv.
ubiubi |  ubiubi см.
ubivis |  ubivis adv.
udus |  udus, a, um поэт.
ulcero |  ulcero, (avi), atum, are
ulcerosus |  ulcerosus, a, um поэт.
ulciscor |  ulciscor, ultus sum, ulcisci
ulcus |  ulcus (hulcus), eris n
uligo |  uligo, inis f
Ulixes |  Ulixes, is (ei) m
ullus |  ullus, a, um gen.
ulmus |  ulmus, i f
ulna |  ulna, ae f
Ulnaceae |  Ulnaceae, arum f
ulnaris |  ulnaris, e анат.
ulnocarpeus |  ulnocarpeus, a, um анат.
ulter |  ulter, tra, trum compar.
ulterior |  ulterior, ius, gen.
ultimum |  I ultimum adv.
ultimus |  ultimus, a, um superl.
ultio |  ultio, onis f
ultor |  ultor, oris m
ultra |  I ultra adv.
Ultrabilum |  Ultrabil(um, i n
Ultracortenum |  Ultracorten(um, i n
Ultralanum |  Ultralan(um, i n
Ultranolum |  Ultranol(um, i n
Ultrasulfanum |  Ultrasulfan(um, i n
Ultrasulfonum |  Ultrasulfon(um, i n
ultrix |  ultrix, icis f
ultro |  ultro adv.
ulula |  ulula, ae f
ululatus |  ululatus, us m
ululo |  ululo, avi, atum, are поэт.
ulva |  ulva, ae f
umbellatus |  umbellatus, a, um биолог.
umbellifer |  umbellifer, era, erum
umbelliflorus |  umbelliflorus, a, um биолог.
umbilicalis |  umbilicalis, e анат.
umbilicus |  umbilicus, i m
umbo |  umbo, onis m
umbra |  umbra, ae f
umbraculum |  umbraculum, i n
Umbradilum |  Umbradil(um, i n
Umbragnostum |  Umbragnost(um, i n
Umbri |  Umbri, orum m
Umbria |  Umbria, ae f
umbrifer |  umbrifer, era, erum
umbro |  umbro, avi, atum, are
umbrosus |  umbrosus, a, um поэт.
ume |  ume...
umor |  umor
umquam |  umquam adv.
una |  una adv.
unanimitas |  unanimitas, atis f
unanimus |  unanimus, a, um
Unazidum |  Unazid(um, i n
uncia |  uncia, ae f
unciarius |  unciarius, a, um
unciformis |  unciformis, e анат.
uncinatus |  uncinatus, a, um анат.
unctio |  unctio, onis f
unctus |  unctus, a, um
uncus |  I uncus, a, um m
unda |  unda, ae f
unde |  unde adv.
undecies |  undecies (undeciens) adv.
undecim |  undecim
undecimus |  undecimus, a, um
Undecinum |  Undecin(um, i n
undeni |  undeni, ae, a
undeoctoginta |  undeoctoginta
undequinquagesimus |  undequinquagesimus, a, um
undequinquaginta |  undequinquaginta
undesexaginta |  undesexaginta
undetricesimus |  undetricesimus, a, um
undevicesimus |  undevicesimus (undevigesimus), a, um
undeviginti |  undeviginti
Undevitum |  Undevit(um, i n
undique |  undique adv.
undo |  undo, avi, atum, are поэт.
undosus |  undosus, a, um
unetvicesimani |  unetvicesimani, orum m
unetvicesimus |  unetvicesimus, a, um
ungo |  ungo (unguo), unxi, unctum, ere поэт.
unguen |  unguen, inis n
unguentarius |  unguentarius, i m
unguentum |  I unguentum, i n
Unguetolum |  Unguetol(um, i n
unguicularis |  unguicularis, e анат.
unguiculatus |  unguiculatus, a, um анат.
unguiculus |  unguiculus, i m
unguis |  unguis, is m
ungula |  ungula, ae f
unguo |  unguo, unxi, unctum, ere
unice |  unice adv.
unicellularis |  unicellularis, e анат.
unicolor |  unicolor, oris
unicus |  unicus, a, um
uniflorus |  uniflorus, a, um биолог.
unilateralis |  unilateralis, e анат.
unilocularis |  unilocularis, e анат.
unimanus |  unimanus, a, um
unipennatus |  unipennatus, a, um анат.
unipolaris |  unipolaris, e анат.
unisexualis |  unisexualis, e биолог.
Unithiolum |  Unithiol(um, i n
uniusmodi |  uniusmodi (также раздельно unius modi) adv.
universe |  universe adv.
universi |  universi, orum m
universitas |  universitas, atis f
universum |  universum, i n
universus |  universus, a, um pl.
unquam |  unquam
unus |  unus ( арх.
upilio |  upilio, onis m
urachus |  urachus, i m
Uradalum |  Uradal(um, i n
uraemia |  uraemia, ae f
uraemicus |  uraemicus, a, um мед.
Uramidum |  Uramid(um, i n
Urania |  Urania, ae f
urbane |  urbane adv.
urbani |  urbani, orum m
urbanitas |  urbanitas, atis f
urbanus |  urbanus, a, um
urbs |  urbs, urbis f
urceus |  urceus, i m
urea |  urea, ae f
Ureaphilum |  Ureaphil(um, i n
Uregitum |  Uregit(um, i n
ureter |  ureter, eris m
uretericus |  uretericus, a, um анат.
ureterographia |  ureterographia, ae f
Urethanum |  Urethan(um, i n
urethra |  urethra, ae f
urethralis |  urethralis, e анат.
urethrographia |  urethrographia, ae f
Urevertum |  Urevert(um, i n
urgeo |  urgeo (urgneo), ursi, --, ere поэт.
Uricidum |  Uricid(um, i n
urina |  urina, ae f
urinator |  urinator, oris m
Uriodonum |  Uriodon(um, i n
Urisolum |  Urisol(um, i n
urna |  urna, ae f
uro |  uro, ussi, ustum, ere pass.
Urobesalolum |  Urobesalol(um, i n
Urocarminum |  Urocarmin(um, i n
urocarpus |  urocarpus, a, um биолог.
Urodanum |  Urodan(um, i n
Urodiazinum |  Urodiazin(um, i n
Urofortum |  Urofort(um, i n
urogenitalis |  urogenitalis, e мед.
Urografinum |  Urografin(um, i n
Urografum |  Urograf(um, i n
urographia |  urographia, ae f
Urokonum |  Urokon(um, i n
urolithus |  urolithus, i m
Urombralum |  Urombral(um, i n
Uronalum |  Uronal(um, i n
uropoesis |  uropoesis, is f
uropoeticus |  uropoeticus, a, um анат.
Uropolynum |  Uropolyn(um, i n
urorectalis |  urorectalis, e анат.
Urosalum |  Urosal(um, i n
Urosolum |  Urosol(um, i n
Urospectum |  Urospect(um, i n
Urosulfanum |  Urosulfan(um, i n
Urotrastum |  Urotrast(um, i n
Urotropinum |  Urotropin(um, i n
Urovisonum |  Urovison(um, i n
Urozinum |  Urozin(um, i n
ursa |  ursa, ae f
Ursalinum |  Ursalin(um, i n
Ursaдlum |  Ursaдl(um, i n
ursus |  ursus, i m
Urtica |  Urtica, ae f
urtica |  urtica, ae f
Urtosalum |  Urtosal(um, i n
urus |  urus, i m
Urutinum |  Urutin(um, i n
Usipetes |  Usipetes, um m
usitatus |  usitatus, a, um
uspiam |  uspiam adv.
usquam |  usquam adv.
usque |  usque adv.
ustor |  ustor, oris m
usucapio |  I usucapio (usus capio), onis f
usura |  usura, ae f
usurpatio |  usurpatio, onis f
usurpo |  usurpo, avi, atum, are
usus |  usus, us m
ususfructus |  ususfructus, us m
ut |  I ut ( арх.
utcumque |  utcumque (utcunque) adv.
utensilia |  utensilia, ium n
uter |  I uter, utra, utrum gen.
utercumque |  utercumque (utercunque), utracumquo, utrumcumque
uterinus |  uterinus, a, um анат.
uterlibet |  uterlibet, utralibet, utrumlibet
Uterolum |  Uterol(um, i n
uteroovaricus |  uteroovaricus, a, um анат.
Uterotonylum |  Uterotonyl(um, i n
uterovaginalis |  uterovaginalis, e анат.
uterque |  uterque, utraque, utrumque gen.
uterus |  uterus, i m
utervis |  utervis, utravis, utrumvis gen.
uti |  uti
Utica |  Utica, ae f
Uticenses |  Uticenses, ium m
utilis |  utilis, e
utilitas |  utilitas, atis f
utiliter |  utiliter adv.
utinam |  utinam adv.
utique |  I utique adv.
utor |  utor, usus sum, uti
utpote |  utpote adv.
utrarius |  utrarius, i m
utricularis |  utricularis, e анат.
utriculoampullaris |  utriculoampullaris, e анат.
utriculus |  utriculus, i m
utrimque |  utrimque (utrinque) adv.
utro |  utro adv.
utrobique |  utrobique
utroque |  utroque adv.
utrubique |  utrubique (utrobique) adv.
utrum |  utrum adv.
utut |  utut adv.
Uva |  Uva ursi бот.
uva |  uva, ae f
uvea |  uvea, ae f
uvesco |  uvesco, --, --, ere
uvidus |  uvidus, a, um поэт.
Uvilonum |  Uvilon(um, i n
uvula |  uvula, ae f
uxor |  uxor, oris f
uxorius |  uxorius, a, um поэт.
